Successfully added cut lay CO
Successfully added cut lay VIA1
Successfully added cut lay VIA2
Successfully added cut lay VIA3
Successfully added cut lay VIA4
Successfully added cut lay VIA5
Successfully added cut lay VIA6
Successfully added cut lay VIA7
Successfully added cut lay VIA8
Successfully added cut lay VIARDL
Cell Min-Routing-Layer = M1
Cell Max-Routing-Layer = M8
Turn off antenna since no rule is specified
Warning: Option route.detail.force_end_on_preferred_grid will be ignored since none of the layers have preferred grid. (ZRT-703)
Warning: Cannot find a default contact code for layer CO. (ZRT-022)
track auto-fill added 2 tracks on M1
track auto-fill added 2 tracks on M2
track auto-fill added 2 tracks on M3
track auto-fill added 2 tracks on M4
track auto-fill added 2 tracks on M5
track auto-fill added 2 tracks on M6
track auto-fill added 2 tracks on M7
track auto-fill added 2 tracks on M8
track auto-fill added 2 tracks on M9
track auto-fill added 1 tracks on MRDL
Found 0 pin access route guide groups.
Info: number of net_type_blockage: 0 
Information: When applicable Min-max layer allow_pin_connection mode will allow paths of length 5.32 outside the layer range. (ZRT-707)
Information: When applicable layer based tapering will taper up to 0.00 in distance from the pin. (ZRT-706)
Total number of nets = 41962, of which 0 are not extracted
Total number of open nets = 0, of which 0 are frozen
[DBIn Done] Elapsed real time: 0:00:03 
[DBIn Done] Elapsed cpu  time: sys=0:00:00 usr=0:00:20 total=0:00:20
[DBIn Done] Stage (MB): Used  127  Alloctr  128  Proc    0 
[DBIn Done] Total (MB): Used  131  Alloctr  132  Proc 6873 


Start checking for open nets ... 

Total number of nets = 41962, of which 0 are not extracted
Total number of open nets = 0, of which 0 are frozen

Check 41962 nets, 0 have Errors

[CHECK OPEN NETS] Elapsed real time: 0:00:00 
[CHECK OPEN NETS] Elapsed cpu  time: sys=0:00:00 usr=0:00:00 total=0:00:00
[CHECK OPEN NETS] Stage (MB): Used    0  Alloctr    0  Proc    0 
[CHECK OPEN NETS] Total (MB): Used  129  Alloctr  131  Proc 6873 
Printing options for 'route.common.*'
common.advance_node_timing_driven_mode                  :	 false               
common.aggressive_blockage_via_modeling                 :	 false               
common.allow_connection_to_stripe_covered_secondary_pg_pin:	 false               
common.allow_pg_as_shield                               :	 true                
common.allow_tie_off_connect_to_shield                  :	 true                
common.check_shield                                     :	 true                
common.clock_net_max_layer_mode                         :	 unknown             
common.clock_net_min_layer_mode                         :	 unknown             
common.clock_topology                                   :	 normal              
common.color_based_dpt_flow                             :	 false               
common.comb_distance                                    :	 2                   
common.concurrent_redundant_via_effort_level            :	 low                 
common.concurrent_redundant_via_mode                    :	 off                 
common.connect_floating_shapes                          :	 false               
common.connect_with_pin_width_on_macros                 :	 false               
common.connect_with_pin_width_on_macros_effort_level    :	 low                 
common.connect_with_pin_width_on_top_level_ports        :	 false               
common.connect_within_pins_by_layer_name                :	                     
common.continue_with_frozen_global_route                :	 false               
common.create_floating_shields                          :	 false               
common.create_nets_for_floating_pins_pattern_must_join_via_ladder:	 false               
common.crosstalk_effort_level                           :	 low                 
common.dbin_enable_safe_via_array_reading               :	 true                
common.debug_read_patterned_metal_shapes                :	 true                
common.derive_connect_within_pin_via_region             :	 false               
common.eco_route_concurrent_redundant_via_effort_level  :	 low                 
common.eco_route_concurrent_redundant_via_mode          :	 off                 
common.eco_route_fix_existing_drc                       :	 true                
common.enable_aggressive_stack_range_over_max_stack_level_fixing:	 false               
common.enable_multi_thread                              :	 true                
common.enable_non_zero_blockage_ek_block                :	 false               
common.enable_pin_width_connection                      :	 false               
common.enable_single_connection_for_var_width           :	 true                
common.enable_via_extension_blocking_for_blockage       :	 true                
common.extra_nonpreferred_direction_wire_cost_multiplier_by_layer_name:	                     
common.extra_preferred_direction_wire_cost_multiplier_by_layer_name:	                     
common.extra_via_cost_multiplier_by_layer_name          :	                     
common.extra_via_off_grid_cost_multiplier_by_layer_name :	                     
common.filter_custom_via_def_with_no_vias               :	 false               
common.filter_redundant_via_mapping                     :	 true                
common.floorplan_aware_hier_va_gr                       :	 true                
common.focus_scenario                                   :	 none                
common.forbid_new_metal_by_layer_name                   :	                     
common.forbid_odd_pitch_jog_by_layer_name               :	                     
common.freeze_layer_by_layer_name                       :	                     
common.freeze_via_to_frozen_layer_by_layer_name         :	                     
common.global_max_layer_mode                            :	 soft                
common.global_min_layer_mode                            :	 soft                
common.high_resistance_flow                             :	 true                
common.ignore_soft_drc_at_final_eco_stage               :	 false               
common.ignore_var_spacing_to_blockage                   :	 false               
common.ignore_var_spacing_to_pg                         :	 false               
common.ignore_var_spacing_to_shield                     :	 true                
common.interactive_mode_clear_timing                    :	 true                
common.mark_clock_nets_minor_change                     :	 true                
common.min_edge_offset_for_macro_pin_connection_by_layer_name:	                     
common.min_edge_offset_for_secondary_pg_pin_connection_by_layer_name:	                     
common.min_edge_offset_for_top_level_pin_connection_by_layer_name:	                     
common.min_max_layer_distance_threshold                 :	 0                   
common.min_shield_length_by_layer_name                  :	                     
common.ndr_by_delta_voltage                             :	 false               
common.net_max_layer_mode                               :	 hard                
common.net_max_layer_mode_soft_cost                     :	 medium              
common.net_min_layer_mode                               :	 soft                
common.net_min_layer_mode_soft_cost                     :	 medium              
common.no_merge_ndr_rule_for_single_connection          :	 false               
common.number_of_secondary_pg_pin_connections           :	 0                   
common.number_of_vias_over_global_max_layer             :	 1                   
common.number_of_vias_over_net_max_layer                :	 1                   
common.number_of_vias_under_global_min_layer            :	 1                   
common.number_of_vias_under_net_min_layer               :	 1                   
common.optimize_big_via_for_pin_access                  :	 false               
common.optimize_for_dense_pin_access                    :	 false               
common.optimize_for_fat_pin_access                      :	 true                
common.optimize_for_pin_access                          :	 false               
common.pg_shield_distance_threshold                     :	 0                   
common.pin_spacing_control_mode                         :	 true                
common.post_detail_route_fix_soft_violations            :	 false               
common.post_detail_route_redundant_via_insertion        :	 off                 
common.post_eco_route_fix_soft_violations               :	 false               
common.post_group_route_fix_soft_violations             :	 false               
common.post_incremental_detail_route_fix_soft_violations:	 false               
common.prevent_bridge_pattern                           :	 {secondary_pg false} {clock false}
common.process_design_masters_in_dbin                   :	 false               
common.process_pg_augmentation_shapes                   :	 false               
common.prune_orphaned_and_floating_nets_shapes_mode     :	 none                
common.query_based_shield_ratio_reporting               :	 false               
common.rc_driven_setup_effort_level                     :	 medium              
common.reconnect_pin_after_shield_modification          :	 false               
common.reduce_shield_same_net_drcs                      :	 false               
common.redundant_via_exclude_weight_group_by_layer_name :	                     
common.redundant_via_include_weight_group_by_layer_name :	                     
common.relax_soft_spacing_outside_min_max_layer         :	 true                
common.reroute_clock_shapes                             :	 false               
common.reroute_user_shapes                              :	 false               
common.reshield_modified_nets                           :	 off                 
common.rotate_default_vias                              :	 true                
common.route_soft_rule_effort_level                     :	 medium              
common.route_top_boundary_mode                          :	 stay_inside         
common.routing_rule_effort_level                        :	                     
common.secondary_pg_pin_effort_level                    :	 hard                
common.separate_tie_off_from_secondary_pg               :	 false               
common.shield_tie_off_max_detail_route_iteration        :	 3                   
common.shielding_nets                                   :	                     
common.single_connection_to_pins                        :	 off                 
common.skip_pg_augmentation_rects                       :	 false               
common.skip_pg_augmentation_wires_and_vias              :	 false               
common.skip_pnet_ignore_shapes                          :	 false               
common.soft_rule_weight_to_effort_level_map             :	 {low low} {medium medium} {high high}
common.threshold_noise_ratio                            :	 0.35                
common.tie_all_out_of_boundary_via_ladder_ports         :	 false               
common.tie_off_mode                                     :	 all                 
common.track_auto_fill                                  :	 true                
common.track_use_area                                   :	 false               
common.track_width_constraint_relaxed_mode              :	 0                   
common.treat_all_analog_nets_as_signal_nets_for_routing :	 false               
common.treat_all_cover_cells_as_lib_cells_for_routing   :	 false               
common.treat_all_scan_nets_as_signal_nets_for_routing   :	 true                
common.treat_rectangles_as_routes                       :	 false               
common.treat_via_array_as_big_via                       :	 false               
common.use_min_shield_length_as_ndr_spacing_length_threshold:	 false               
common.use_weighted_secondary_pg_pin_count              :	 false               
common.verbose_level                                    :	 1                   
common.via_array_mode                                   :	 all                 
common.via_ladder_ndr_mode                              :	 full                
common.via_ladder_top_layer_overrides_net_min_layer     :	 false               
common.via_on_grid_by_layer_name                        :	                     
common.virtual_flat                                     :	 false               
common.voltage_area_aware                               :	 relaxed             
common.weighted_number_of_secondary_pg_pin_connections  :	 0                   
common.wide_macro_pin_as_fat_wire                       :	 false               
common.wire_on_grid_by_layer_name                       :	                     
common.write_instance_via_color                         :	 false               

Printing options for 'route.detail.*'
detail.allow_default_rule_nets_via_ladder_lower_layer_connection:	 false               
detail.allow_fixed_shape_extension_to_overlap_with_zero_spacing_blockage:	 false               
detail.allow_ndr_nets_via_ladder_lower_layer_connection :	 false               
detail.antenna                                          :	 true                
detail.antenna_fixing_preference                        :	 hop_layers          
detail.antenna_on_iteration                             :	 1                   
detail.antenna_verbose_level                            :	 1                   
detail.cache_via_enc_for_fat_wire_via_kpt_encl          :	 false               
detail.check_antenna_for_open_nets                      :	 false               
detail.check_antenna_on_abutting_pins                   :	 true                
detail.check_antenna_on_diode_pins                      :	 false               
detail.check_antenna_on_pg                              :	 false               
detail.check_encl_for_xy_dir_mincut_fat_via_rule        :	 true                
detail.check_on_wire_track_for_non_prefer_metal         :	 true                
detail.check_patchable_drc_from_fixed_shapes            :	 false               
detail.check_pin_access_via_mismatch                    :	 true                
detail.check_pin_min_area_min_length                    :	 true                
detail.check_port_min_area_min_length                   :	 true                
detail.check_routes_frozen_mode_include_shape_with_attribute_locked:	 false               
detail.continue_after_large_design_rule_value_error     :	 false               
detail.cost_adjustment_during_redundant_via_insertion   :	 false               
detail.debug_check_cellmap_query_for_diodes         

 
detail.generate_extra_off_grid_pin_tracks               :	 false               
detail.generate_off_grid_feed_through_tracks            :	 low                 
detail.group_route_special_design_rule_fixing_stage     :	 late_routing        
detail.hop_layers_to_fix_antenna                        :	 true                
detail.ignore_contained_metal_for_via_based_metal_min_width:	 true                
detail.ignore_drc                                       :	 {same_net_metal_space false} {same_net_enclosed_cut_space false} {all_same_net_drc_for_frozen_net false}
detail.ignore_needs_fat_contact_drcs_from_far_off_shapes:	 true                
detail.improve_optimize_route_runtime                   :	 false               
detail.improve_secondary_pg_topology                    :	 false               
detail.incremental_detail_route_special_design_rule_fixing_stage:	 late_routing        
detail.insert_diodes_during_routing                     :	 false               
detail.insert_redundant_vias_layer_order_low_to_high    :	 false               
detail.keep_track_color_for_large_shape                 :	 false               
detail.macro_pin_antenna_mode                           :	 normal              
detail.max_antenna_pin_count                            :	 -1                  
detail.merge_gates_for_antenna                          :	 true                
detail.min_number_iterations_after_last_patch_clean_up_iteration:	 3                   
detail.ndr_layer_based_taper_distance_threshold         :	 -1                  
detail.obs_patch_threshold_by_layer_name                :	                     
detail.on_wire_track_width_threshold_by_layer_name      :	                     
detail.optimize_for_aprg                                :	 false               
detail.optimize_for_cuts_near_pg                        :	 false               
detail.optimize_for_macro_pin_offset                    :	 false               
detail.optimize_for_macro_pins                          :	 false               
detail.optimize_for_non_pref_dir_route                  :	 false               
detail.optimize_partition_size_for_drc                  :	 false               
detail.optimize_tie_off_effort_level                    :	 low                 
detail.optimize_wire_via_effort_level                   :	 low                 
detail.patch_clean_up_iteration_frequency               :	 5                   
detail.patch_clean_up_iterations                        :	                     
detail.patch_clean_up_max_number_iterations             :	 0                   
detail.patch_clean_up_reconnect_open_net                :	 false               
detail.patch_clean_up_trimming_only                     :	 false               
detail.pattern_must_join_check_on_user_secondary_pg     :	 false               
detail.pin_taper_mode                                   :	 default_width       
detail.port_antenna_mode                                :	 float               
detail.post_process_special_design_rule_fixing_stage    :	 late_routing        
detail.prevent_bridge_pattern                           :	 {secondary_pg false} {clock false}
detail.process_gate_area_of_pins_on_metal_layers        :	 false               
detail.process_min_edge_length_drc_fixing_on_overlap_shapes:	 false               
detail.process_min_edge_length_drc_fixing_on_wide_width_tracks:	 true                
detail.process_min_edge_length_drc_fixing_with_via_swapping:	 true                
detail.process_min_edge_length_drc_on_large_shapes      :	 false               
detail.process_min_length_on_shapes_with_other_drcs     :	 true                
detail.process_other_layer_patch_for_iso_dense_via_enclosure:	 true                
detail.process_other_layer_patch_for_iso_dense_via_enclosure_2:	 true                
detail.process_patchable_drcs_in_diode_insertion        :	 true                
detail.process_via_enclosure_based_max_length_drcs_on_long_wires:	 true                
detail.reject_input_vio_type_in_alt_via_try_mode        :	 true                
detail.repair_shorts_over_macros_effort_level           :	 off                 
detail.repair_shorts_over_macros_verbose                :	 false               
detail.report_antenna_for_must_join_port_root           :	 false               
detail.report_ignore_drc                                :	                     
detail.reuse_filler_locations_for_diodes                :	 true                
detail.route_guide_based_min_area_by_layer_name         :	                     
detail.save_after_iterations                            :	                     
detail.save_cell_prefix                                 :	 DR                  
detail.save_with_best_drc_after_iteration               :	 -1                  
detail.save_with_best_drc_cell_name                     :	 DR_itrBestDRC       
detail.save_with_best_drc_reduction_threshold           :	 30                  
detail.skip_antenna_fixing_for_nets                     :	                     
detail.skip_m0_pg_pins_only_cell_for_1cpp_cell_gap_analysis:	 false               
detail.skip_no_m0_shapes_cells_for_1cpp_cell_gap        :	 false               
detail.skip_obs_patch_for_cut_aware_min_length          :	 true                
detail.sparse_end_extension_for_via_enclosure_patch_threshold_by_layer_name:	                     
detail.speedup_secondary_pg_routing                     :	 true                
detail.threshold_adjustment_for_single_connection_to_pins:	 false               
detail.timing_driven                                    :	 true                
detail.top_layer_antenna_fix_threshold                  :	 -1                  
detail.topology_eco_effort_level                        :	 medium              
detail.trim_pin_spots_for_custom_via_cuts               :	 false               
detail.use_blockage_over_pin_via_for_fat_wire_via_enclosure:	 true                
detail.use_default_width_for_min_area_min_len_stub      :	 false               
detail.use_diode_prot_based_max_ratio_for_diode_mode_16 :	 false               
detail.use_layer_check_for_fat_via_patching             :	 true                
detail.use_lower_hierarchy_for_port_diodes              :	 false               
detail.use_wide_wire_effort_level                       :	 off                 
detail.use_wide_wire_to_input_pin                       :	 false               
detail.use_wide_wire_to_macro_pin                       :	 false               
detail.use_wide_wire_to_output_pin                      :	 false               
detail.use_wide_wire_to_pad_pin                         :	 same_as_macro_pin   
detail.use_wide_wire_to_port                            :	 same_as_macro_pin   
detail.user_defined_partition                           :	                     
detail.var_spacing_to_same_net                          :	 false               
detail.via_ladder_ndr_mode                              :	 full                
detail.via_ladder_upper_layer_via_connection_mode       :	 above               
detail.write_voltage_area_drcs_to_error_data_file       :	 true                

Printing options for 'route.auto_via_ladder.*'
auto_via_ladder.allow_drcs                              :	 false               
auto_via_ladder.allow_patching                          :	 false               
auto_via_ladder.allow_samenet_intersection              :	 false               
auto_via_ladder.allow_via_array_as_single_cut           :	 false               
auto_via_ladder.apply_app_options_to_insert_via_ladders_command:	 false               
auto_via_ladder.auto_stagger                            :	 false               
auto_via_ladder.auto_stagger_for_em_via_ladder_max_number_stagger_tracks_per_level:	 15                  
auto_via_ladder.auto_stagger_max_number_stagger_tracks_per_level:	 9                   
auto_via_ladder.bias_top_layer_to_samenet_connection    :	 false               
auto_via_ladder.check_drcs_on_existing_via_ladders      :	 false               
auto_via_ladder.clean                                   :	 false               
auto_via_ladder.connect_within_metal                    :	 false               
auto_via_ladder.connect_within_metal_for_em_via_ladder  :	 same_as_global      
auto_via_ladder.connect_within_metal_for_via_ladder     :	 same_as_global      
auto_via_ladder.connect_within_pin_mode                 :	 {all off} {via_ladder off} {pattern_must_join off}
auto_via_ladder.default_width_ndr_promotable_on_nonreserved_tracks:	 true                
auto_via_ladder.enable_em_to_performance_via_ladder_update:	 false               
auto_via_ladder.force_shifted_vias_flush_with_line_ends :	 true                
auto_via_ladder.generate_center_track_on_off_grid_pattern_must_join_pin_shapes:	 false               
auto_via_ladder.generate_track_width_by_layer_name      :	                     
auto_via_ladder.ignore_min_max_layer_constraints        :	 false               
auto_via_ladder.ignore_rippable_shapes                  :	 false               
auto_via_ladder.ignore_routing_shape_drcs               :	 false               
auto_via_ladder.ndr_mode                                :	 full                
auto_via_ladder.ndr_on_top_layer_only                   :	 false               
auto_via_ladder.pattern_must_join_max_number_stagger_tracks:	                     
auto_via_ladder.pattern_must_join_over_pin_layer        :	 1                   
auto_via_ladder.pin_access_aware                        :	 true                
auto_via_ladder.relax_line_end_via_enclosure_rule       :	 false               
auto_via_ladder.relax_pin_layer_metal_spacing_rules     :	 false               
auto_via_ladder.remove_routing_shapes_below_net_via_ladder_top_layer:	 false               
auto_via_ladder.report_all_via_ladders                  :	 true                
auto_via_ladder.shift_vias_on_transition_layers         :	 false               
auto_via_ladder.strictly_honor_cut_table                :	 false               
auto_via_ladder.top_layer_to_samenet_min_nonzero_distance:	 0                   
auto_via_ladder.update_during_route                     :	 false               
auto_via_ladder.update_on_route_eco_nets_only           :	 false               
auto_via_ladder.update_on_route_group_nets_only         :	 false               
auto_via_ladder.update_pattern_must_join_during_route   :	 true                
auto_via_ladder.user_debug                              :	 false               
auto_via_ladder.verbose                                 :	 false               


Begin full DRC check ...

Information: Using 8 threads for routing. (ZRT-444)
Checked	1/64 Partitions, Violations =	823
Checked	2/64 Partitions, Violations =	2867
Checked	4/64 Partitions, Violations =	3657
Checked	6/64 Partitions, Violations =	4990
Checked	8/64 Partitions, Violations =	7633
Checked	10/64 Partitions, Violations =	8443
Checked	12/64 Partitions, Violations =	9932
Checked	14/64 Partitions, Violations =	11382
Checked	16/64 Partitions, Violations =	13765
Checked	18/64 Partitions, Violations =	15608
Checked	20/64 Partitions, Violations =	17114
Checked	22/64 Partitions, Violations =	18697
Checked	24/64 Partitions, Violations =	21238
Checked	26/64 Partitions, Violations =	22758
Checked	28/64 Partitions, Violations =	24390
Checked	30/64 Partitions, Violations =	26296
Checked	32/64 Partitions, Violations =	28103
Checked	34/64 Partitions, Violations =	30176
Checked	36/64 Partitions, Violations =	32007
Checked	38/64 Partitions, Violations =	34212
Checked	40/64 Partitions, Violations =	36108
Checked	42/64 Partitions, Violations =	37973
Checked	44/64 Partitions, Violations =	41509
Checked	46/64 Partitions, Violations =	42317
Checked	48/64 Partitions, Violations =	43657
Checked	50/64 Partitions, Violations =	46466
Checked	52/64 Partitions, Violations =	48489
Checked	54/64 Partitions, Violations =	49867
Checked	56/64 Partitions, Violations =	51276
Checked	58/64 Partitions, Violations =	53123
Checked	60/64 Partitions, Violations =	54763
Checked	62/64 Partitions, Violations =	57467
Checked	64/64 Partitions, Violations =	59367
[DRC CHECK] Elapsed real time: 0:00:44 
[DRC CHECK] Elapsed cpu  time: sys=0:00:04 usr=0:03:34 total=0:03:39
[DRC CHECK] Stage (MB): Used    4  Alloctr    6  Proc   40 
[DRC CHECK] Total (MB): Used  194  Alloctr  198  Proc 6914 
Warning: No antenna rules defined, Skip antenna analysis. (ZRT-309)
Information: Merged away 26379 aligned/redundant DRCs. (ZRT-305)

DRC-SUMMARY:
	@@@@@@@ TOTAL VIOLATIONS =	32988
	Diff net spacing : 14420
	End of line enclosure : 1
	Less than minimum area : 3
	Less than minimum enclosed area : 21
	Less than minimum width : 41
	Protrusion length : 1
	Same net spacing : 6336
	Short : 8
	Via-Metal Concave corner rule : 12157



begin full chip DRC detailed report

EBox: M1-M1 [1075990,1614320..1076570,1615150] (aps_rename_912_,n8496) Diff net spacing
EBox: M1-M1 [590170,3560500..597380,3573100] (n4053,n4054) Diff net spacing
EBox: M1-M1 [928940,3794580..936150,3807180] (n4065,n4066) Diff net spacing
EBox: M1-M1 [1197550,2992550..1207780,3005420] (n4328,n4330) Diff net spacing
EBox: M1-M1 [4272550,258480..4273130,260080] (final_out[1850],n14323) Diff net spacing
EBox: M1-M1 [2041150,4250330..2051350,4262650] (n3984,n5030) Diff net spacing
EBox: M1-M1 [1579120,3000560..1579690,3002160] (n4042,n5037) Diff net spacing
EBox: M1-M1 [1610990,2978610..1621670,2991930] (n4041,n5038) Diff net spacing
EBox: M1-M1 [872310,3936880..872890,3938480] (n4772,n4774) Diff net spacing
EBox: M1-M1 [2420250,2917540..2432280,2925830] (aps_rename_300_,n15197) Diff net spacing
EBox: M1-M1 [506770,3714020..515110,3726620] (n4937,n5404) Diff net spacing
EBox: M1-M1 [1395320,4388770..1407350,4397190] (final_out[1284],n15485) Diff net spacing
EBox: M1-M1 [1509320,4463130..1521350,4471420] (final_out[1283],n15485) Diff net spacing
EBox: M1-M1 [2812950,1458390..2827030,1469670] (final_out[550],n14903) Diff net spacing
EBox: M1-M1 [2813930,1458340..2827030,1469670] (final_out[550],n14903) Diff net spacing
EBox: M1-M1 [2258680,4422340..2270710,4430630] (aps_rename_838_,n15377) Diff net spacing
EBox: M1-M1 [2098010,4496570..2110040,4504860] (final_out[581],n15353) Diff net spacing
EBox: M1-M1 [2102570,4530010..2114600,4539820] (final_out[579],n15353) Diff net spacing
EBox: M1-M1 [2403530,4320500..2415560,4330310] (aps_rename_1012_,n15305) Diff net spacing
EBox: M1-M1 [1091320,4362810..1103350,4371100] (final_out[263],n15293) Diff net spacing
EBox: M1-M1 [1120200,4322020..1132230,4330310] (final_out[262],n15293) Diff net spacing
EBox: M1-M1 [1091320,4329370..1103350,4337660] (final_out[261],n15293) Diff net spacing
EBox: M1-M1 [1001640,4353940..1013670,4363750] (aps_rename_1031_,n15293) Diff net spacing
EBox: M1-M1 [1287400,4188260..1299430,4196550] (final_out[193],n15281) Diff net spacing
EBox: M1-M1 [936730,4229050..948760,4237090] (aps_rename_1141_,n15257) Diff net spacing
EBox: M1-M1 [576490,1942970..582630,1956230] (n5957,n6267) Diff net spacing
EBox: M1-M1 [571310,1942270..582630,1955290] (n6267,n6269) Diff net spacing
EBox: M1-M1 [898730,1487750..905450,1501590] (n6364,n7216) Diff net spacing
EBox: M1-M1 [605180,3728090..612390,3740690] (n6999,n9127) Diff net spacing
EBox: M1-M1 [2147590,945420..2148170,946460] (n8125,n8126) Diff net spacing
EBox: M1-M1 [717850,1138870..725830,1151870] (n8675,n8679) Diff net spacing
EBox: M1-M1 [3309000,2215300..3321030,2223590] (n17516,pipeline_chain_31__u_seq2/memory[127]) Diff net spacing
EBox: M1-M1 [3434090,2256090..3446120,2264380] (n17508,pipeline_chain_31__u_seq2/memory[118]) Diff net spacing
EBox: M1-M1 [3473160,2322970..3485190,2331370] (n17516,pipeline_chain_31__u_seq2/memory[126]) Diff net spacing
EBox: M1-M1 [3500520,2322970..3512550,2331280] (n17508,pipeline_chain_31__u_seq2/memory[116]) Diff net spacing
EBox: M1-M1 [3529850,2347540..3541880,2357350] (n17516,pipeline_chain_31__u_seq2/memory[124]) Diff net spacing
EBox: M1-M1 [3768040,2189210..3780070,2197680] (n17508,pipeline_chain_31__u_seq2/memory[115]) Diff net spacing
EBox: M1-M1 [3684890,2356410..3696920,2364700] (n17516,pipeline_chain_31__u_seq2/memory[122]) Diff net spacing
EBox: M1-M1 [3795850,2189210..3807880,2197500] (n17508,pipeline_chain_31__u_seq2/memory[112]) Diff net spacing
EBox: M1-M1 [3526360,2155770..3538390,2164060] (n17508,pipeline_chain_31__u_seq2/memory[109]) Diff net spacing
EBox: M1-M1 [3746760,2155770..3758790,2164060] (n17508,pipeline_chain_31__u_seq2/memory[107]) Diff net spacing
EBox: M1-M1 [3795850,2184650..3809430,2194460] (n17521,pipeline_chain_31__u_seq2/memory[112]) Diff net spacing
EBox: M1-M1 [3795850,2184900..3808950,2194710] (n17521,pipeline_chain_31__u_seq2/memory[112]) Diff net spacing
EBox: M1-M1 [3525290,2148670..3537320,2156710] (n17521,pipeline_chain_31__u_seq2/memory[109]) Diff net spacing
EBox: M1-M1 [3730490,2122330..3742520,2132140] (n17521,pipeline_chain_31__u_seq2/memory[107]) Diff net spacing
EBox: M1-M1 [3377850,2148420..3389880,2156710] (n17521,pipeline_chain_31__u_seq2/memory[101]) Diff net spacing
EBox: M1-M1 [3685960,2248740..3697990,2257030] (n17504,pipeline_chain_31__u_seq2/memory[82]) Diff net spacing
EBox: M1-M1 [3424970,2189210..3437000,2197500] (n17504,pipeline_chain_31__u_seq2/memory[79]) Diff net spacing
EBox: M1-M1 [3795850,2181860..3807880,2190150] (n17521,pipeline_chain_31__u_seq2/memory[96]) Diff net spacing
EBox: M1-M1 [3499450,2314100..3511480,2323910] (n17504,pipeline_chain_31__u_seq2/memory[76]) Diff net spacing
EBox: M1-M1 [3766970,2256090..3779000,2264380] (n17517,pipeline_chain_31__u_seq2/memory[88]) Diff net spacing
EBox: M1-M1 [3013050,2248550..3025080,2257030] (n17422,pipeline_chain_30__u_seq2/memory[119]) Diff net spacing
EBox: M1-M1 [3716810,2146900..3728840,2156710] (n17504,pipeline_chain_31__u_seq2/memory[73]) Diff net spacing
EBox: M1-M1 [3134200,2650020..3146230,2658310] (n17422,pipeline_chain_30__u_seq2/memory[118]) Diff net spacing
EBox: M1-M1 [3499750,2317140..3512250,2328080] (n17508,pipeline_chain_31__u_seq2/memory[76]) Diff net spacing
EBox: M1-M1 [3844040,2122330..3856070,2132140] (n17504,pipeline_chain_31__u_seq2/memory[72]) Diff net spacing
EBox: M1-M1 [3212170,2456730..3224200,2466540] (n17407,pipeline_chain_30__u_seq2/memory[101]) Diff net spacing
EBox: M1-M1 [3210200,2414420..3222230,2424230] (n17422,pipeline_chain_30__u_seq2/memory[115]) Diff net spacing
EBox: M1-M1 [2988730,2356410..3000760,2365140] (n17422,pipeline_chain_30__u_seq2/memory[111]) Diff net spacing
EBox: M1-M1 [3064730,2248680..3076760,2257030] (n17407,pipeline_chain_30__u_seq2/memory[96]) Diff net spacing
EBox: M1-M1 [3114890,2657370..3126920,2667180] (n17422,pipeline_chain_30__u_seq2/memory[110]) Diff net spacing
EBox: M1-M1 [3209130,2213780..3221160,2223590] (n17422,pipeline_chain_30__u_seq2/memory[107]) Diff net spacing
EBox: M1-M1 [2953320,2315620..2965350,2323910] (n17421,pipeline_chain_30__u_seq2/memory[103]) Diff net spacing
EBox: M1-M1 [3070810,2623930..3082840,2633740] (n17421,pipeline_chain_30__u_seq2/memory[102]) Diff net spacing
EBox: M1-M1 [2892520,2950980..2904550,2959270] (n17312,pipeline_chain_29__u_seq2/memory[118]) Diff net spacing
EBox: M1-M1 [3523320,2314100..3535350,2323910] (n17519,pipeline_chain_31__u_seq2/memory[68]) Diff net spacing
EBox: M1-M1 [3794330,2122330..3806360,2132140] (n17519,pipeline_chain_31__u_seq2/memory[67]) Diff net spacing
EBox: M1-M1 [3689450,2146900..3701480,2156710] (n17519,pipeline_chain_31__u_seq2/memory[65]) Diff net spacing
EBox: M1-M1 [3064730,2683460..3076760,2691750] (n17406,pipeline_chain_30__u_seq2/memory[78]) Diff net spacing
EBox: M1-M1 [3115240,2651540..3127840,2662870] (n17422,pipeline_chain_30__u_seq2/memory[94]) Diff net spacing
EBox: M1-M1 [3115960,2557050..3127990,2565340] (n17418,pipeline_chain_30__u_seq2/memory[89]) Diff net spacing
EBox: M1-M1 [3064730,2356410..3076760,2364700] (n17406,pipeline_chain_30__u_seq2/memory[76]) Diff net spacing
EBox: M1-M1 [3207610,2349060..3219640,2357350] (n17406,pipeline_chain_30__u_seq2/memory[75]) Diff net spacing
EBox: M1-M1 [3424970,2181770..3437000,2190150] (n17514,pipeline_chain_31__u_seq2/memory[53]) Diff net spacing
EBox: M1-M1 [3069290,2649880..3081320,2658310] (n17420,pipeline_chain_30__u_seq2/memory[86]) Diff net spacing
EBox: M1-M1 [3105770,2289530..3117800,2297820] (n17406,pipeline_chain_30__u_seq2/memory[72]) Diff net spacing
EBox: M1-M1 [3552650,2322970..3564680,2331260] (n17514,pipeline_chain_31__u_seq2/memory[52]) Diff net spacing
EBox: M1-M1 [3745690,2148420..3757720,2156710] (n17514,pipeline_chain_31__u_seq2/memory[51]) Diff net spacing
EBox: M1-M1 [3163080,2583040..3175110,2591430] (n17418,pipeline_chain_30__u_seq2/memory[81]) Diff net spacing
EBox: M1-M1 [3184360,2347540..3196390,2357350] (n17420,pipeline_chain_30__u_seq2/memory[83]) Diff net spacing
EBox: M1-M1 [3005450,2389850..3017480,2398140] (n17406,pipeline_chain_30__u_seq2/memory[68]) Diff net spacing
EBox: M1-M1 [3182840,2549700..3194870,2557990] (n17420,pipeline_chain_30__u_seq2/memory[81]) Diff net spacing
EBox: M1-M1 [2757690,2849140..2769720,2858950] (n17325,pipeline_chain_29__u_seq2/memory[113]) Diff net spacing
EBox: M1-M1 [3655560,2347540..3667590,2357350] (n17502,pipeline_chain_31__u_seq2/memory[34]) Diff net spacing
EBox: M1-M1 [2854970,2690810..2867000,2699100] (n17325,pipeline_chain_29__u_seq2/memory[112]) Diff net spacing
EBox: M1-M1 [3084490,2581620..3096520,2591430] (n17406,pipeline_chain_30__u_seq2/memory[65]) Diff net spacing
EBox: M1-M1 [2891450,2958330..2903480,2966620] (n17324,pipeline_chain_29__u_seq2/memory[110]) Diff net spacing
EBox: M1-M1 [3101210,2683460..3113240,2691750] (n17420,pipeline_chain_30__u_seq2/memory[78]) Diff net spacing
EBox: M1-M1 [2754650,2657370..2766680,2665660] (n17316,pipeline_chain_29__u_seq2/memory[101]) Diff net spacing
EBox: M1-M1 [2874280,2950880..2886310,2959270] (n17325,pipeline_chain_29__u_seq2/memory[110]) Diff net spacing
EBox: M1-M1 [3205640,2447860..3217670,2457670] (n17412,pipeline_chain_30__u_seq2/memory[69]) Diff net spacing
EBox: M1-M1 [3086010,2318410..3099110,2328470] (n17408,pipeline_chain_30__u_seq2/memory[64]) Diff net spacing
EBox: M1-M1 [3199560,2322970..3211590,2331260] (n17420,pipeline_chain_30__u_seq2/memory[75]) Diff net spacing
EBox: M1-M1 [2746600,2690810..2758630,2699100] (n17324,pipeline_chain_29__u_seq2/memory[106]) Diff net spacing
EBox: M1-M1 [3114890,2549450..3126920,2557990] (n17412,pipeline_chain_30__u_seq2/memory[65]) Diff net spacing
EBox: M1-M1 [2891450,2716900..2903480,2725190] (n17324,pipeline_chain_29__u_seq2/memory[104]) Diff net spacing
EBox: M1-M1 [3086010,2315620..3098040,2323910] (n17412,pipeline_chain_30__u_seq2/memory[64]) Diff net spacing
EBox: M1-M1 [2584410,2657370..2596440,2665660] (n17316,pipeline_chain_29__u_seq2/memory[95]) Diff net spacing
EBox: M1-M1 [2907720,2683460..2919750,2691750] (n17325,pipeline_chain_29__u_seq2/memory[104]) Diff net spacing
EBox: M1-M1 [2949210,2349060..2961240,2357350] (n17412,pipeline_chain_30__u_seq2/memory[63]) Diff net spacing
EBox: M1-M1 [4703290,4697210..4715320,4705500] (n17217,pipeline_chain_28__u_seq2/memory[124]) Diff net spacing
EBox: M1-M1 [3767270,2183380..3779770,2194240] (n17508,pipeline_chain_31__u_seq2/memory[27]) Diff net spacing
EBox: M1-M1 [2967450,2481300..2979480,2491110] (n17412,pipeline_chain_30__u_seq2/memory[58]) Diff net spacing
EBox: M1-M1 [3066250,2616580..3078280,2624870] (n17419,pipeline_chain_30__u_seq2/memory[62]) Diff net spacing
EBox: M1-M1 [2871240,2817220..2883270,2825510] (n17315,pipeline_chain_29__u_seq2/memory[84]) Diff net spacing
EBox: M1-M1 [3003930,2322970..3015960,2331340] (n17408,pipeline_chain_30__u_seq2/memory[47]) Diff net spacing
EBox: M1-M1 [2564200,2690810..2576230,2699100] (n17314,pipeline_chain_29__u_seq2/memory[79]) Diff net spacing
EBox: M1-M1 [2911210,2950980..2923240,2959270] (n17314,pipeline_chain_29__u_seq2/memory[78]) Diff net spacing
EBox: M1-M1 [2814230,2626530..2826730,2633690] (n17314,pipeline_chain_29__u_seq2/memory[77]) Diff net spacing
EBox: M1-M1 [2815000,2623930..2827030,2633740] (n17314,pipeline_chain_29__u_seq2/memory[77]) Diff net spacing
EBox: M1-M1 [5032680,4990820..5045160,4999110] (n17220,pipeline_chain_28__u_seq2/memory[111]) Diff net spacing
EBox: M1-M1 [2908170,2884040..2920200,2892390] (n17314,pipeline_chain_29__u_seq2/memory[76]) Diff net spacing
EBox: M1-M1 [4694170,4823620..4706200,4831910] (n17220,pipeline_chain_28__u_seq2/memory[108]) Diff net spacing
EBox: M1-M1 [2696890,2690810..2708920,2699100] (n17315,pipeline_chain_29__u_seq2/memory[74]) Diff net spacing
EBox: M1-M1 [2891450,2690810..2903480,2699100] (n17314,pipeline_chain_29__u_seq2/memory[72]) Diff net spacing
EBox: M1-M1 [2594600,2683450..2606630,2691750] (n17314,pipeline_chain_29__u_seq2/memory[71]) Diff net spacing
EBox: M1-M1 [2851930,2924890..2863960,2933180] (n17314,pipeline_chain_29__u_seq2/memory[70]) Diff net spacing
EBox: M1-M1 [3067770,2315530..3079800,2323910] (n17408,pipeline_chain_30__u_seq2/memory[36]) Diff net spacing
EBox: M1-M1 [4995130,4730650..5007160,4738970] (n17226,pipeline_chain_28__u_seq2/memory[110]) Diff net spacing
EBox: M1-M1 [4982520,4764090..4994550,4772410] (n17226,pipeline_chain_28__u_seq2/memory[109]) Diff net spacing
EBox: M1-M1 [2892520,2891450..2904800,2901260] (n17314,pipeline_chain_29__u_seq2/memory[68]) Diff net spacing
EBox: M1-M1 [2620890,2748820..2632920,2758630] (n17314,pipeline_chain_29__u_seq2/memory[67]) Diff net spacing
EBox: M1-M1 [3086010,2322970..3098040,2331260] (n17408,pipeline_chain_30__u_seq2/memory[32]) Diff net spacing
EBox: M1-M1 [4718490,4964730..4730520,4973020] (n17226,pipeline_chain_28__u_seq2/memory[105]) Diff net spacing
EBox: M1-M1 [4981450,4998170..4993480,5006460] (n17226,pipeline_chain_28__u_seq2/memory[103]) Diff net spacing
EBox: M1-M1 [3043000,2616580..3055030,2624870] (n17410,pipeline_chain_30__u_seq2/memory[30]) Diff net spacing
EBox: M1-M1 [3184360,2482820..3196390,2491110] (n17410,pipeline_chain_30__u_seq2/memory[29]) Diff net spacing
EBox: M1-M1 [3108360,2215300..3120390,2223590] (n17424,pipeline_chain_30__u_seq2/memory[40]) Diff net spacing
EBox: M1-M1 [4853320,4990820..4865350,4999110] (n17226,pipeline_chain_28__u_seq2/memory[98]) Diff net spacing
EBox: M1-M1 [4852250,5057520..4864280,5065990] (n17221,pipeline_chain_28__u_seq2/memory[90]) Diff net spacing
EBox: M1-M1 [4449000,4221700..4461030,4229990] (n17133,pipeline_chain_27__u_seq2/memory[127]) Diff net spacing
EBox: M1-M1 [2809370,2824570..2821400,2832860] (n17310,pipeline_chain_29__u_seq2/memory[44]) Diff net spacing
EBox: M1-M1 [4379530,4188110..4391560,4196550] (n17130,pipeline_chain_27__u_seq2/memory[119]) Diff net spacing
EBox: M1-M1 [3145290,2657370..3157320,2665660] (n17411,pipeline_chain_30__u_seq2/memory[14]) Diff net spacing
EBox: M1-M1 [4272680,4052980..4284710,4062790] (n17136,pipeline_chain_27__u_seq2/memory[123]) Diff net spacing
EBox: M1-M1 [2616330,2683460..2628360,2691750] (n17328,pipeline_chain_29__u_seq2/memory[58]) Diff net spacing
EBox: M1-M1 [3114890,2456730..3126920,2465020] (n17411,pipeline_chain_30__u_seq2/memory[13]) Diff net spacing
EBox: M1-M1 [4156090,4153300..4168120,4163110] (n17119,pipeline_chain_27__u_seq2/memory[105]) Diff net spacing
EBox: M1-M1 [4329370,4052980..4341400,4062790] (n17130,pipeline_chain_27__u_seq2/memory[115]) Diff net spacing
EBox: M1-M1 [2718170,2884100..2730200,2892390] (n17322,pipeline_chain_29__u_seq2/memory[49]) Diff net spacing
EBox: M1-M1 [5011400,4764090..5023430,4772380] (n17218,pipeline_chain_28__u_seq2/memory[70]) Diff net spacing
EBox: M1-M1 [4329370,4061850..4341400,4070140] (n17136,pipeline_chain_27__u_seq2/memory[115]) Diff net spacing
EBox: M1-M1 [4468760,4255140..4480790,4263430] (n17130,pipeline_chain_27__u_seq2/memory[109]) Diff net spacing
EBox: M1-M1 [4884170,4790180..4896200,4798470] (n17218,pipeline_chain_28__u_seq2/memory[69]) Diff net spacing
EBox: M1-M1 [4666810,4823620..4678840,4831910] (n17218,pipeline_chain_28__u_seq2/memory[67]) Diff net spacing
EBox: M1-M1 [4950600,5031610..4962630,5039950] (n17218,pipeline_chain_28__u_seq2/memory[66]) Diff net spacing
EBox: M1-M1 [5025080,4663770..5037110,4673580] (n17230,pipeline_chain_28__u_seq2/memory[78]) Diff net spacing
EBox: M1-M1 [4184970,4153300..4197000,4163110] (n17130,pipeline_chain_27__u_seq2/memory[105]) Diff net spacing
EBox: M1-M1 [4733690,4723300..4745720,4731590] (n17216,pipeline_chain_28__u_seq2/memory[60]) Diff net spacing
EBox: M1-M1 [4720010,4897850..4732040,4906140] (n17218,pipeline_chain_28__u_seq2/memory[59]) Diff net spacing
EBox: M1-M1 [4852250,5024260..4864280,5032550] (n17218,pipeline_chain_28__u_seq2/memory[58]) Diff net spacing
EBox: M1-M1 [4703290,5031610..4715320,5039900] (n17218,pipeline_chain_28__u_seq2/memory[57]) Diff net spacing
EBox: M1-M1 [4865930,4957380..4877960,4965670] (n17218,pipeline_chain_28__u_seq2/memory[56]) Diff net spacing
EBox: M1-M1 [5028570,4823620..5040600,4831910] (n17216,pipeline_chain_28__u_seq2/memory[54]) Diff net spacing
EBox: M1-M1 [4885240,5024100..4897270,5032550] (n17230,pipeline_chain_28__u_seq2/memory[66]) Diff net spacing
EBox: M1-M1 [4139370,2289530..4151400,2297820] (n17029,pipeline_chain_26__u_seq2/memory[120]) Diff net spacing
EBox: M1-M1 [4671370,5031610..4683400,5039900] (n17216,pipeline_chain_28__u_seq2/memory[49]) Diff net spacing
EBox: M1-M1 [4476810,4086420..4488840,4096230] (n17132,pipeline_chain_27__u_seq2/memory[92]) Diff net spacing
EBox: M1-M1 [3138760,2256090..3150790,2264380] (n17425,pipeline_chain_30__u_seq2/memory[0]) Diff net spacing
EBox: M1-M1 [2501880,2649940..2513910,2658310] (n17326,pipeline_chain_29__u_seq2/memory[23]) Diff net spacing
EBox: M1-M1 [4184970,2483190..4197000,2491110] (n17024,pipeline_chain_26__u_seq2/memory[101]) Diff net spacing
EBox: M1-M1 [2675610,2681940..2687640,2691750] (n17326,pipeline_chain_29__u_seq2/memory[18]) Diff net spacing
EBox: M1-M1 [4336520,2490170..4348550,2499980] (n17034,pipeline_chain_26__u_seq2/memory[108]) Diff net spacing
EBox: M1-M1 [4105930,2148420..4117960,2156710] (n17024,pipeline_chain_26__u_seq2/memory[96]) Diff net spacing
EBox: M1-M1 [4305050,2222650..4317080,2231050] (n17034,pipeline_chain_26__u_seq2/memory[106]) Diff net spacing
EBox: M1-M1 [4379530,2415940..4391560,2424230] (n17024,pipeline_chain_26__u_seq2/memory[94]) Diff net spacing
EBox: M1-M1 [4156090,2282180..4168120,2290470] (n17035,pipeline_chain_26__u_seq2/memory[104]) Diff net spacing
EBox: M1-M1 [4350650,2523610..4362680,2531900] (n17034,pipeline_chain_26__u_seq2/memory[103]) Diff net spacing
EBox: M1-M1 [2697960,2657370..2709990,2665660] (n17329,pipeline_chain_29__u_seq2/memory[10]) Diff net spacing
EBox: M1-M1 [4314170,4329370..4326200,4337660] (n17137,pipeline_chain_27__u_seq2/memory[74]) Diff net spacing
EBox: M1-M1 [2810440,2917790..2822470,2925830] (n17329,pipeline_chain_29__u_seq2/memory[9]) Diff net spacing
EBox: M1-M1 [4344570,4320500..4356600,4330310] (n17122,pipeline_chain_27__u_seq2/memory[58]) Diff net spacing
EBox: M1-M1 [2914250,2623930..2926280,2632220] (n17329,pipeline_chain_29__u_seq2/memory[8]) Diff net spacing
EBox: M1-M1 [3940250,2783590..3952280,2792070] (n16938,pipeline_chain_25__u_seq2/memory[127]) Diff net spacing
EBox: M1-M1 [4301560,4086420..4313590,4096230] (n17134,pipeline_chain_27__u_seq2/memory[67]) Diff net spacing
EBox: M1-M1 [4437290,4188260..4449320,4196550] (n17122,pipeline_chain_27__u_seq2/memory[55]) Diff net spacing
EBox: M1-M1 [4282250,4329370..4294280,4337660] (n17134,pipeline_chain_27__u_seq2/memory[66]) Diff net spacing
EBox: M1-M1 [4380600,2490170..4392630,2498460] (n17027,pipeline_chain_26__u_seq2/memory[87]) Diff net spacing
EBox: M1-M1 [2891450,2884100..2903480,2892390] (n17329,pipeline_chain_29__u_seq2/memory[4]) Diff net spacing
EBox: M1-M1 [3880520,2657370..3892550,2665660] (n16938,pipeline_chain_25__u_seq2/memory[124]) Diff net spacing
EBox: M1-M1 [4350650,2349060..4362680,2357350] (n17028,pipeline_chain_26__u_seq2/memory[86]) Diff net spacing
EBox: M1-M1 [3894200,2482820..3906230,2491110] (n16938,pipeline_chain_25__u_seq2/memory[123]) Diff net spacing
EBox: M1-M1 [4303080,2490170..4315110,2498460] (n17027,pipeline_chain_26__u_seq2/memory[84]) Diff net spacing
EBox: M1-M1 [3659050,2557050..3671080,2565340] (n16938,pipeline_chain_25__u_seq2/memory[121]) Diff net spacing
EBox: M1-M1 [4329370,2256090..4341400,2264380] (n17028,pipeline_chain_26__u_seq2/memory[82]) Diff net spacing
EBox: M1-M1 [4300490,4320500..4312520,4330310] (n17134,pipeline_chain_27__u_seq2/memory[58]) Diff net spacing
EBox: M1-M1 [3880520,2716900..3892550,2725190] (n16940,pipeline_chain_25__u_seq2/memory[118]) Diff net spacing
EBox: M1-M1 [4248360,4322020..4260390,4330310] (n17134,pipeline_chain_27__u_seq2/memory[56]) Diff net spacing
EBox: M1-M1 [4238170,2449330..4250200,2457670] (n17028,pipeline_chain_26__u_seq2/memory[77]) Diff net spacing
EBox: M1-M1 [5046810,4789990..5058840,4798470] (n17231,pipeline_chain_28__u_seq2/memory[22]) Diff net spacing
EBox: M1-M1 [3789320,2549700..3801350,2557990] (n16940,pipeline_chain_25__u_seq2/memory[114]) Diff net spacing
EBox: M1-M1 [3862730,2817220..3874760,2825510] (n16929,pipeline_chain_25__u_seq2/memory[102]) Diff net spacing
EBox: M1-M1 [4350200,2482820..4362230,2491110] (n17023,pipeline_chain_26__u_seq2/memory[68]) Diff net spacing
EBox: M1-M1 [3893130,2490170..3905160,2498460] (n16940,pipeline_chain_25__u_seq2/memory[112]) Diff net spacing
EBox: M1-M1 [4397770,3961530..4409800,3969820] (n17123,pipeline_chain_27__u_seq2/memory[38]) Diff net spacing
EBox: M1-M1 [3961530,2683460..3973560,2691750] (n16932,pipeline_chain_25__u_seq2/memory[100]) Diff net spacing
EBox: M1-M1 [4449000,4095290..4461030,4103580] (n17124,pipeline_chain_27__u_seq2/memory[36]) Diff net spacing
EBox: M1-M1 [3814090,2523610..3826120,2531900] (n16940,pipeline_chain_25__u_seq2/memory[107]) Diff net spacing
EBox: M1-M1 [3698570,2523610..3710600,2532050] (n16932,pipeline_chain_25__u_seq2/memory[98]) Diff net spacing
EBox: M1-M1 [3745690,2557050..3757720,2565340] (n16940,pipeline_chain_25__u_seq2/memory[106]) Diff net spacing
EBox: M1-M1 [5031610,4797530..5043640,4805930] (n17232,pipeline_chain_28__u_seq2/memory[14]) Diff net spacing
EBox: M1-M1 [3864250,2456730..3876280,2465380] (n16932,pipeline_chain_25__u_seq2/memory[96]) Diff net spacing
EBox: M1-M1 [4934330,4730650..4946360,4740460] (n17228,pipeline_chain_28__u_seq2/memory[5]) Diff net spacing
EBox: M1-M1 [4754970,4723300..4767000,4731590] (n17228,pipeline_chain_28__u_seq2/memory[4]) Diff net spacing
EBox: M1-M1 [3959560,2590490..3971590,2598780] (n16926,pipeline_chain_25__u_seq2/memory[85]) Diff net spacing
EBox: M1-M1 [4642490,2824570..4654520,2832860] (n16837,pipeline_chain_24__u_seq2/memory[124]) Diff net spacing
EBox: M1-M1 [5014440,4990580..5026470,4999110] (n17232,pipeline_chain_28__u_seq2/memory[7]) Diff net spacing
EBox: M1-M1 [4800570,4931290..4812600,4939580] (n17228,pipeline_chain_28__u_seq2/memory[0]) Diff net spacing
EBox: M1-M1 [4313720,4019540..4325750,4029350] (n17120,pipeline_chain_27__u_seq2/memory[19]) Diff net spacing
EBox: M1-M1 [4884170,4990400..4896200,4999110] (n17232,pipeline_chain_28__u_seq2/memory[2]) Diff net spacing
EBox: M1-M1 [4671370,2490170..4683400,2499980] (n16842,pipeline_chain_24__u_seq2/memory[118]) Diff net spacing
EBox: M1-M1 [4623800,2817220..4635830,2825510] (n16842,pipeline_chain_24__u_seq2/memory[116]) Diff net spacing
EBox: M1-M1 [4508730,2982900..4520760,2992710] (n16842,pipeline_chain_24__u_seq2/memory[115]) Diff net spacing
EBox: M1-M1 [3920040,2449380..3932070,2457670] (n16931,pipeline_chain_25__u_seq2/memory[75]) Diff net spacing
EBox: M1-M1 [4624250,2389850..4636280,2398190] (n16842,pipeline_chain_24__u_seq2/memory[114]) Diff net spacing
EBox: M1-M1 [4621210,2924890..4633240,2934700] (n16842,pipeline_chain_24__u_seq2/memory[113]) Diff net spacing
EBox: M1-M1 [4464200,4154380..4476230,4163110] (n17118,pipeline_chain_27__u_seq2/memory[4]) Diff net spacing
EBox: M1-M1 [4017770,2783780..4029800,2792070] (n16931,pipeline_chain_25__u_seq2/memory[71]) Diff net spacing
EBox: M1-M1 [4277240,2222650..4289270,2232460] (n17039,pipeline_chain_26__u_seq2/memory[51]) Diff net spacing
EBox: M1-M1 [4344120,4262490..4356150,4270780] (n17118,pipeline_chain_27__u_seq2/memory[2]) Diff net spacing
EBox: M1-M1 [4233610,4255140..4245640,4263430] (n17118,pipeline_chain_27__u_seq2/memory[0]) Diff net spacing
EBox: M1-M1 [4409930,3994970..4421960,4003260] (n17135,pipeline_chain_27__u_seq2/memory[14]) Diff net spacing
EBox: M1-M1 [4658760,2924890..4670790,2933180] (n16842,pipeline_chain_24__u_seq2/memory[105]) Diff net spacing
EBox: M1-M1 [4630330,2449380..4642360,2457670] (n16830,pipeline_chain_24__u_seq2/memory[90]) Diff net spacing
EBox: M1-M1 [4642790,2584660..4655290,2595570] (n16833,pipeline_chain_24__u_seq2/memory[93]) Diff net spacing
EBox: M1-M1 [4009720,2557050..4021750,2565340] (n16944,pipeline_chain_25__u_seq2/memory[69]) Diff net spacing
EBox: M1-M1 [4670920,2984280..4682950,2992710] (n16845,pipeline_chain_24__u_seq2/memory[97]) Diff net spacing
EBox: M1-M1 [3721370,2581620..3733400,2591430] (n16944,pipeline_chain_25__u_seq2/memory[58]) Diff net spacing
EBox: M1-M1 [4662250,3760890..4674280,3769180] (n16736,pipeline_chain_23__u_seq2/memory[103]) Diff net spacing
EBox: M1-M1 [4206250,2222650..4218280,2230940] (n17038,pipeline_chain_26__u_seq2/memory[19]) Diff net spacing
EBox: M1-M1 [4867000,3760890..4879030,3769180] (n16737,pipeline_chain_23__u_seq2/memory[102]) Diff net spacing
EBox: M1-M1 [4697210,3954160..4709240,3962470] (n16736,pipeline_chain_23__u_seq2/memory[99]) Diff net spacing
EBox: M1-M1 [4210810,2447860..4222840,2457670] (n17037,pipeline_chain_26__u_seq2/memory[13]) Diff net spacing
EBox: M1-M1 [4724570,3952660..4736600,3962470] (n16736,pipeline_chain_23__u_seq2/memory[96]) Diff net spacing
EBox: M1-M1 [4724570,3994970..4736600,4004780] (n16737,pipeline_chain_23__u_seq2/memory[97]) Diff net spacing
EBox: M1-M1 [4499610,2882850..4511640,2892390] (n16836,pipeline_chain_24__u_seq2/memory[67]) Diff net spacing
EBox: M1-M1 [4660730,2884100..4672760,2892390] (n16847,pipeline_chain_24__u_seq2/memory[76]) Diff net spacing
EBox: M1-M1 [4495050,2817220..4507080,2825510] (n16836,pipeline_chain_24__u_seq2/memory[64]) Diff net spacing
EBox: M1-M1 [4689610,3794330..4701640,3802620] (n16736,pipeline_chain_23__u_seq2/memory[92]) Diff net spacing
EBox: M1-M1 [3551130,4362810..3563160,4371200] (n16640,pipeline_chain_22__u_seq2/memory[119]) Diff net spacing
EBox: M1-M1 [4592330,2456730..4604360,2465090] (n16836,pipeline_chain_24__u_seq2/memory[58]) Diff net spacing
EBox: M1-M1 [3791290,2683400..3803320,2691750] (n16928,pipeline_chain_25__u_seq2/memory[12]) Diff net spacing
EBox: M1-M1 [3783240,4429690..3795270,4437980] (n16650,pipeline_chain_22__u_seq2/memory[117]) Diff net spacing
EBox: M1-M1 [4963210,3961530..4975240,3969820] (n16735,pipeline_chain_23__u_seq2/memory[74]) Diff net spacing
EBox: M1-M1 [3745690,2549510..3757720,2557990] (n16928,pipeline_chain_25__u_seq2/memory[10]) Diff net spacing
EBox: M1-M1 [3912890,4287060..3924920,4296870] (n16657,pipeline_chain_22__u_seq2/memory[123]) Diff net spacing
EBox: M1-M1 [3842970,4329370..3855000,4337780] (n16650,pipeline_chain_22__u_seq2/memory[115]) Diff net spacing
EBox: M1-M1 [3893130,2549700..3905160,2557990] (n16928,pipeline_chain_25__u_seq2/memory[8]) Diff net spacing
EBox: M1-M1 [3814090,2514740..3826120,2524550] (n16928,pipeline_chain_25__u_seq2/memory[3]) Diff net spacing
EBox: M1-M1 [3814390,2514790..3826890,2521950] (n16928,pipeline_chain_25__u_seq2/memory[3]) Diff net spacing
EBox: M1-M1 [4564970,2690810..4577000,2699100] (n16844,pipeline_chain_24__u_seq2/memory[47]) Diff net spacing
EBox: M1-M1 [3763930,4295930..3775960,4304220] (n16644,pipeline_chain_22__u_seq2/memory[102]) Diff net spacing
EBox: M1-M1 [3859690,4288610..3871720,4296870] (n16644,pipeline_chain_22__u_seq2/memory[99]) Diff net spacing
EBox: M1-M1 [4023400,4455780..4035430,4464070] (n16650,pipeline_chain_22__u_seq2/memory[105]) Diff net spacing
EBox: M1-M1 [3782170,4422340..3794200,4430630] (n16656,pipeline_chain_22__u_seq2/memory[109]) Diff net spacing
EBox: M1-M1 [4657690,2958330..4669720,2966620] (n16844,pipeline_chain_24__u_seq2/memory[41]) Diff net spacing
EBox: M1-M1 [3889640,2690810..3901670,2699190] (n16938,pipeline_chain_25__u_seq2/memory[6]) Diff net spacing
EBox: M1-M1 [3891610,4463130..3903640,4471420] (n16644,pipeline_chain_22__u_seq2/memory[96]) Diff net spacing
EBox: M1-M1 [3623640,4463130..3635670,4471420] (n16644,pipeline_chain_22__u_seq2/memory[95]) Diff net spacing
EBox: M1-M1 [4592330,3794330..4604360,3804140] (n16748,pipeline_chain_23__u_seq2/memory[71]) Diff net spacing
EBox: M1-M1 [3716810,4489400..3728840,4497510] (n16644,pipeline_chain_22__u_seq2/memory[93]) Diff net spacing
EBox: M1-M1 [4038600,4463130..4050630,4471420] (n16656,pipeline_chain_22__u_seq2/memory[105]) Diff net spacing
EBox: M1-M1 [3633210,2523610..3645240,2531900] (n16938,pipeline_chain_25__u_seq2/memory[2]) Diff net spacing
EBox: M1-M1 [4768650,3760890..4780680,3770700] (n16748,pipeline_chain_23__u_seq2/memory[68]) Diff net spacing
EBox: M1-M1 [4853320,3853650..4865350,3862150] (n16740,pipeline_chain_23__u_seq2/memory[60]) Diff net spacing
EBox: M1-M1 [3844040,4295930..3856070,4304370] (n16644,pipeline_chain_22__u_seq2/memory[91]) Diff net spacing
EBox: M1-M1 [3791290,2514740..3803320,2524550] (n16938,pipeline_chain_25__u_seq2/memory[0]) Diff net spacing
EBox: M1-M1 [3951960,4463130..3963990,4471560] (n16644,pipeline_chain_22__u_seq2/memory[89]) Diff net spacing
EBox: M1-M1 [4659210,3686660..4671240,3694950] (n16738,pipeline_chain_23__u_seq2/memory[55]) Diff net spacing
EBox: M1-M1 [4914120,3794330..4926150,3802620] (n16740,pipeline_chain_23__u_seq2/memory[56]) Diff net spacing
EBox: M1-M1 [4599930,2490170..4611960,2498550] (n16846,pipeline_chain_24__u_seq2/memory[29]) Diff net spacing
EBox: M1-M1 [4690680,3894650..4702710,3902690] (n16748,pipeline_chain_23__u_seq2/memory[59]) Diff net spacing
EBox: M1-M1 [4815770,3961530..4827800,3969820] (n16740,pipeline_chain_23__u_seq2/memory[49]) Diff net spacing
EBox: M1-M1 [4598410,2817220..4610440,2825510] (n16833,pipeline_chain_24__u_seq2/memory[12]) Diff net spacing
EBox: M1-M1 [4523930,2824570..4535960,2832950] (n16833,pipeline_chain_24__u_seq2/memory[8]) Diff net spacing
EBox: M1-M1 [3912440,4322010..3924470,4330310] (n16638,pipeline_chain_22__u_seq2/memory[67]) Diff net spacing
EBox: M1-M1 [3894200,4396250..3906230,4404660] (n16638,pipeline_chain_22__u_seq2/memory[64]) Diff net spacing
EBox: M1-M1 [3572410,4454260..3584440,4464070] (n16638,pipeline_chain_22__u_seq2/memory[63]) Diff net spacing
EBox: M1-M1 [4528490,2516260..4540520,2524550] (n16837,pipeline_chain_24__u_seq2/memory[5]) Diff net spacing
EBox: M1-M1 [3668170,4429690..3680200,4437980] (n16638,pipeline_chain_22__u_seq2/memory[60]) Diff net spacing
EBox: M1-M1 [4447930,2884100..4459960,2892390] (n16837,pipeline_chain_24__u_seq2/memory[3]) Diff net spacing
EBox: M1-M1 [3859240,4321980..3871270,4330310] (n16638,pipeline_chain_22__u_seq2/memory[59]) Diff net spacing
EBox: M1-M1 [4660730,2891450..4672760,2899770] (n16837,pipeline_chain_24__u_seq2/memory[1]) Diff net spacing
EBox: M1-M1 [4624250,2791130..4636280,2799420] (n16849,pipeline_chain_24__u_seq2/memory[12]) Diff net spacing
EBox: M1-M1 [3561770,4429690..3573800,4439500] (n16653,pipeline_chain_22__u_seq2/memory[71]) Diff net spacing
EBox: M1-M1 [3864250,4362810..3876280,4371220] (n16638,pipeline_chain_22__u_seq2/memory[56]) Diff net spacing
EBox: M1-M1 [4621210,2820010..4633810,2831340] (n16842,pipeline_chain_24__u_seq2/memory[4]) Diff net spacing
EBox: M1-M1 [4642490,2456730..4654520,2465020] (n16849,pipeline_chain_24__u_seq2/memory[10]) Diff net spacing
EBox: M1-M1 [4642490,2916020..4654520,2925830] (n16849,pipeline_chain_24__u_seq2/memory[9]) Diff net spacing
EBox: M1-M1 [4730200,4355460..4742230,4363750] (n16545,pipeline_chain_21__u_seq2/memory[87]) Diff net spacing
EBox: M1-M1 [4447930,2924890..4459960,2934700] (n16849,pipeline_chain_24__u_seq2/memory[3]) Diff net spacing
EBox: M1-M1 [4893290,4255140..4905320,4263430] (n16545,pipeline_chain_21__u_seq2/memory[83]) Diff net spacing
EBox: M1-M1 [3976730,4422410..3988760,4430630] (n16654,pipeline_chain_22__u_seq2/memory[58]) Diff net spacing
EBox: M1-M1 [4569080,3794330..4581110,3802620] (n16751,pipeline_chain_23__u_seq2/memory[23]) Diff net spacing
EBox: M1-M1 [3716810,4496570..3728840,4504860] (n16654,pipeline_chain_22__u_seq2/memory[53]) Diff net spacing
EBox: M1-M1 [4037530,4429690..4049560,4437980] (n16654,pipeline_chain_22__u_seq2/memory[50]) Diff net spacing
EBox: M1-M1 [4592630,3788500..4605130,3799440] (n16748,pipeline_chain_23__u_seq2/memory[15]) Diff net spacing
EBox: M1-M1 [4671120,3961530..4683400,3971340] (n16753,pipeline_chain_23__u_seq2/memory[19]) Diff net spacing
EBox: M1-M1 [4592330,3785460..4604360,3795270] (n16750,pipeline_chain_23__u_seq2/memory[15]) Diff net spacing
EBox: M1-M1 [4592630,3785510..4605130,3792670] (n16750,pipeline_chain_23__u_seq2/memory[15]) Diff net spacing
EBox: M1-M1 [4964280,4020990..4976310,4029350] (n16750,pipeline_chain_23__u_seq2/memory[10]) Diff net spacing
EBox: M1-M1 [4865930,3861210..4877960,3869750] (n16753,pipeline_chain_23__u_seq2/memory[8]) Diff net spacing
EBox: M1-M1 [5010330,3827770..5022360,3837580] (n16750,pipeline_chain_23__u_seq2/memory[5]) Diff net spacing
EBox: M1-M1 [4736730,4322020..4748760,4330310] (n16560,pipeline_chain_21__u_seq2/memory[70]) Diff net spacing
EBox: M1-M1 [4739770,3694010..4751800,3702310] (n16750,pipeline_chain_23__u_seq2/memory[4]) Diff net spacing
EBox: M1-M1 [3783240,4388900..3795270,4397190] (n16642,pipeline_chain_22__u_seq2/memory[22]) Diff net spacing
EBox: M1-M1 [4787960,4455780..4799990,4464070] (n16560,pipeline_chain_21__u_seq2/memory[68]) Diff net spacing
EBox: M1-M1 [4964280,4028410..4976310,4036700] (n16750,pipeline_chain_23__u_seq2/memory[2]) Diff net spacing
EBox: M1-M1 [4667880,4329370..4679910,4337660] (n16556,pipeline_chain_21__u_seq2/memory[63]) Diff net spacing
EBox: M1-M1 [4963210,4429690..4975240,4438170] (n16561,pipeline_chain_21__u_seq2/memory[64]) Diff net spacing
EBox: M1-M1 [4856360,4463130..4868390,4471420] (n16560,pipeline_chain_21__u_seq2/memory[61]) Diff net spacing
EBox: M1-M1 [4990570,4422210..5002600,4430630] (n16556,pipeline_chain_21__u_seq2/memory[57]) Diff net spacing
EBox: M1-M1 [4718790,4323540..4731290,4334380] (n16554,pipeline_chain_21__u_seq2/memory[54]) Diff net spacing
EBox: M1-M1 [4639450,4362810..4651480,4371100] (n16556,pipeline_chain_21__u_seq2/memory[55]) Diff net spacing
EBox: M1-M1 [3749800,4355460..3761830,4363750] (n16642,pipeline_chain_22__u_seq2/memory[12]) Diff net spacing
EBox: M1-M1 [4718490,4320500..4730520,4330310] (n16556,pipeline_chain_21__u_seq2/memory[54]) Diff net spacing
EBox: M1-M1 [4786890,4496570..4798920,4504860] (n16556,pipeline_chain_21__u_seq2/memory[52]) Diff net spacing
EBox: M1-M1 [3977800,4388840..3989830,4397190] (n16642,pipeline_chain_22__u_seq2/memory[9]) Diff net spacing
EBox: M1-M1 [3842970,4522660..3855000,4530950] (n16642,pipeline_chain_22__u_seq2/memory[8]) Diff net spacing
EBox: M1-M1 [4009720,4422340..4021750,4430630] (n16643,pipeline_chain_22__u_seq2/memory[9]) Diff net spacing
EBox: M1-M1 [4756040,4355400..4768070,4363750] (n16546,pipeline_chain_21__u_seq2/memory[15]) Diff net spacing
EBox: M1-M1 [4730650,4295930..4742680,4305740] (n16546,pipeline_chain_21__u_seq2/memory[14]) Diff net spacing
EBox: M1-M1 [4754970,4455780..4767000,4464070] (n16546,pipeline_chain_21__u_seq2/memory[12]) Diff net spacing
EBox: M1-M1 [4865930,4253620..4877960,4263430] (n16546,pipeline_chain_21__u_seq2/memory[8]) Diff net spacing
EBox: M1-M1 [4727610,4429690..4739640,4437980] (n16546,pipeline_chain_21__u_seq2/memory[7]) Diff net spacing
EBox: M1-M1 [4991640,4496570..5003800,4504860] (n16542,pipeline_chain_21__u_seq2/memory[2]) Diff net spacing
EBox: M1-M1 [4934330,4195610..4946360,4203900] (n16546,pipeline_chain_21__u_seq2/memory[3]) Diff net spacing
EBox: M1-M1 [4642490,4496570..4654520,4504860] (n16557,pipeline_chain_21__u_seq2/memory[12]) Diff net spacing
EBox: M1-M1 [763750,646710..776250,654390] (n10171,n9550) Diff net spacing
EBox: M1-M1 [994300,484570..1001510,497170] (n10233,n10234) Diff net spacing
EBox: M1-M1 [4640050,1871780..4647990,1884380] (aps_rename_1697_,n29085) Diff net spacing
EBox: M1-M1 [1490010,4329620..1496130,4342220] (final_out[1280],n31592) Diff net spacing
EBox: M1-M1 [4616650,350010..4623490,364380] (n31322,res_out[1845]) Diff net spacing
EBox: M1-M1 [2201670,987190..2209910,999330] (n11155,n11158) Diff net spacing
EBox: M1-M1 [1496460,1922470..1506770,1935160] (n31241,res_out[918]) Diff net spacing
EBox: M1-M1 [2336650,2511100..2344860,2523700] (n11620,n11622) Diff net spacing
EBox: M1-M1 [3875750,1574140..3881940,1586640] (gre_net_205,n25874) Diff net spacing
EBox: M1-M1 [512650,1587540..521450,1600140] (aps_rename_1902_,n31243) Diff net spacing
EBox: M1-M1 [1556630,771350..1565130,783850] (aps_rename_1911_,n31258) Diff net spacing
EBox: M1-M1 [1588550,1005130..1595830,1019500] (aps_rename_1942_,n31257) Diff net spacing
EBox: M1-M1 [951670,2858260..960470,2870860] (n31226,res_out[137]) Diff net spacing
EBox: M1-M1 [3741130,204340..3748150,216940] (n31562,res_out[127]) Diff net spacing
EBox: M1-M1 [1264470,4589850..1265050,4591220] (n31354,seq1_out[136]) Diff net spacing
EBox: M1-M1 [2661350,4670380..2661930,4671740] (n31347,seq1_out[98]) Diff net spacing
EBox: M1-M1 [2875670,3786550..2876250,3788150] (n31284,seq1_out[25]) Diff net spacing
EBox: M1-M1 [813030,4436300..813610,4437640] (n31331,seq1_out[34]) Diff net spacing
EBox: M1-M1 [758310,4388920..758890,4390520] (n31331,seq1_out[32]) Diff net spacing
EBox: M1-M1 [4866230,4257840..4878730,4267990] (n22435,pipeline_chain_21__u_seq2/memory[8]) Diff net spacing
EBox: M1-M1 [2875670,4302650..2876250,4304250] (n31583,seq1_out[65]) Diff net spacing
EBox: M1-M1 [1829910,711440..1830490,713040] (n25556,n30569) Diff net spacing
EBox: M1-M1 [4444470,2491440..4451310,2504540] (n31491,seq2_out[431]) Diff net spacing
EBox: M1-M1 [4324810,985370..4331830,999740] (n25540,n31418) Diff net spacing
EBox: M1-M1 [2190230,2925670..2201410,2937990] (n25783,n31204) Diff net spacing
EBox: M1-M1 [664650,717850..671670,730450] (n25515,n31531) Diff net spacing
EBox: M1-M1 [628170,1040310..635010,1052910] (n25721,n31532) Diff net spacing
EBox: M1-M1 [2117150,3861990..2128250,3874310] (n26098,n31210) Diff net spacing
EBox: M1-M1 [934790,1842650..945890,1854970] (n26083,n31241) Diff net spacing
EBox: M1-M1 [1282650,3681150..1293970,3694170] (n26154,n31218) Diff net spacing
EBox: M1-M1 [1391410,385220..1399810,397820] (n26298,n31259) Diff net spacing
EBox: M1-M1 [2117130,3581830..2124490,3594630] (n26608,n31212) Diff net spacing
EBox: M1-M1 [1600970,303140..1607990,317510] (n26507,n31472) Diff net spacing
EBox: M1-M1 [4418470,1565680..4419050,1567280] (n26368,n31648) Diff net spacing
EBox: M1-M1 [2703910,3399660..2704490,3401130] (n2778,n31336) Diff net spacing
EBox: M1-M1 [2755590,3867820..2756170,3869150] (n2785,n31353) Diff net spacing
EBox: M1-M1 [2497190,3686960..2497770,3688340] (n2805,n31337) Diff net spacing
EBox: M1-M1 [2583830,3319140..2584410,3320500] (n2792,n31352) Diff net spacing
EBox: M1-M1 [2778390,3920760..2778970,3922360] (n2879,n31284) Diff net spacing
EBox: M1-M1 [2583830,3418560..2584410,3420160] (n2937,n31336) Diff net spacing
EBox: M1-M1 [2509350,3419110..2509930,3420710] (n2930,n31358) Diff net spacing
EBox: M1-M1 [2655270,4121350..2655850,4122950] (n2865,n31480) Diff net spacing
EBox: M1-M1 [2559510,4088250..2560090,4089620] (n2897,n31480) Diff net spacing
EBox: M1-M1 [2196230,2649440..2196810,2651040] (n3067,n31356) Diff net spacing
EBox: M1-M1 [1202150,4202220..1202730,4203630] (n2816,n31596) Diff net spacing
EBox: M1-M1 [2635510,4388320..2636090,4389920] (n2777,n31663) Diff net spacing
EBox: M1-M1 [2583830,4522080..2584410,4523680] (n2840,n31614) Diff net spacing
EBox: M1-M1 [2681110,3920710..2681690,3922310] (n2994,n31595) Diff net spacing
EBox: M1-M1 [2801190,3768160..2801770,3769760] (n2996,n31603) Diff net spacing
EBox: M1-M1 [2314790,3185030..2315370,3186630] (n3047,n31595) Diff net spacing
EBox: M1-M1 [1731110,3265900..1731690,3267280] (n3079,n31595) Diff net spacing
EBox: M1-M1 [2680170,4325060..2693270,4334870] (n15156,n15160) Diff net spacing
EBox: M1-M1 [2680230,4324810..2693330,4334620] (n15156,n15160) Diff net spacing
EBox: M1-M1 [2680170,4329370..2692200,4337660] (n15156,n15161) Diff net spacing
EBox: M1-M1 [2675340,3861210..2687640,3869500] (n15218,n15221) Diff net spacing
EBox: M1-M1 [2485610,4455780..2497640,4464070] (n15241,n15245) Diff net spacing
EBox: M1-M1 [2689300,3789770..2702400,3799830] (n15220,n15329) Diff net spacing
EBox: M1-M1 [1285850,4191350..1298530,4201110] (n15272,n15281) Diff net
EBox: M1-M1 [2360330,3682100..2367990,3694700] (n31205,n5120) Diff net spacing
EBox: M1-M1 [2360460,3681850..2366470,3694090] (n31205,n5120) Diff net spacing
EBox: M1-M1 [3137450,2448800..3138150,2450400] (n15675,n15676) Diff net spacing
EBox: M1-M1 [3346230,1769940..3358730,1777980] (VDD,final_out[617]) Diff net spacing
EBox: M1-M1 [2772890,2879590..2784930,2889350] (n15752,n15753) Diff net spacing
EBox: M1-M1 [2676370,2712340..2688710,2722150] (n15762,n15763) Diff net spacing
EBox: M1-M1 [2590490,2812710..2602530,2822470] (n15772,n15773) Diff net spacing
EBox: M1-M1 [2794170,2693850..2806210,2703610] (n15788,n15789) Diff net spacing
EBox: M1-M1 [2585930,2645460..2598270,2653750] (n15807,n15808) Diff net spacing
EBox: M1-M1 [2506610,2597760..2507350,2598930] (n15812,n15813) Diff net spacing
EBox: M1-M1 [4732170,5001210..4744510,5011020] (n15834,n15835) Diff net spacing
EBox: M1-M1 [5031610,4952820..5043650,4962630] (n15894,n15895) Diff net spacing
EBox: M1-M1 [4257810,4254990..4258390,4256160] (n15900,n15901) Diff net spacing
EBox: M1-M1 [427810,3747460..434550,3761830] (n31369,n5872) Diff net spacing
EBox: M1-M1 [4426650,4212330..4439750,4222140] (n15975,n15976) Diff net spacing
EBox: M1-M1 [4188770,2392890..4201110,2402700] (n15994,n15995) Diff net spacing
EBox: M1-M1 [4349130,2259130..4361170,2268890] (n16004,n16005) Diff net spacing
EBox: M1-M1 [3982810,2494730..3995150,2503020] (n16095,n16096) Diff net spacing
EBox: M1-M1 [3982810,2497570..3994850,2503590] (n16095,n16096) Diff net spacing
EBox: M1-M1 [3981290,2493210..3993330,2502970] (n16096,n16097) Diff net spacing
EBox: M1-M1 [4548250,690740..4561350,702070] (HFSNET_1854,final_out[1389]) Diff net spacing
EBox: M1-M1 [3908330,2727290..3920370,2737100] (n16126,n16127) Diff net spacing
EBox: M1-M1 [4686570,2946470..4698610,2956230] (n16158,n16159) Diff net spacing
EBox: M1-M1 [4675170,2827610..4687510,2837420] (n16192,n16193) Diff net spacing
EBox: M1-M1 [4627290,2545360..4639330,2554950] (n16198,n16199) Diff net spacing
EBox: M1-M1 [4723530,2530880..4724120,2532480] (n16211,n16212) Diff net spacing
EBox: M1-M1 [4719550,2526650..4731590,2536410] (n16212,n16213) Diff net spacing
EBox: M1-M1 [4903720,3868480..4904390,3870080] (n16233,n16234) Diff net spacing
EBox: M1-M1 [4896330,3864250..4908370,3873870] (n16234,n16235) Diff net spacing
EBox: M1-M1 [3702670,4384560..3714710,4394150] (n16356,n16357) Diff net spacing
EBox: M1-M1 [3722770,4537280..3723350,4538880] (n16361,n16362) Diff net spacing
EBox: M1-M1 [3605390,4451490..3617430,4461030] (n16386,n16387) Diff net spacing
EBox: M1-M1 [4978410,4298970..4990450,4308730] (n16392,n16393) Diff net spacing
EBox: M1-M1 [5031610,4484710..5043650,4494470] (n16414,n16415) Diff net spacing
EBox: M1-M1 [4799050,4499610..4811090,4509190] (n16434,n16435) Diff net spacing
EBox: M1-M1 [4804670,4332410..4816710,4342080] (n16454,n16455) Diff net spacing
EBox: M1-M1 [4739770,4399290..4751810,4409050] (n16468,n16469) Diff net spacing
EBox: M1-M1 [5007290,4399290..5020390,4408640] (n16488,n16489) Diff net spacing
EBox: M1-M1 [4941740,4253040..4942390,4254640] (n16503,n16504) Diff net spacing
EBox: M1-M1 [3836310,3848720..3836890,3850320] (n15496,n17530) Diff net spacing
EBox: M1-M1 [4329370,2251530..4342950,2258250] (n16005,n17028) Diff net spacing
EBox: M1-M1 [4845590,4452160..4846170,4453760] (n16523,n16524) Diff net spacing
EBox: M1-M1 [4671370,2485610..4684950,2492330] (n16213,n16842) Diff net spacing
EBox: M1-M1 [4886990,4422190..4887670,4423360] (n16528,n16529) Diff net spacing
EBox: M1-M1 [4990570,4492260..5003800,4502070] (n16542,n16556) Diff net spacing
EBox: M1-M1 [4990700,4492010..5003670,4501820] (n16542,n16556) Diff net spacing
EBox: M1-M1 [4739290,4324810..4751350,4334620] (n16549,n16560) Diff net spacing
EBox: M1-M1 [4718790,4328370..4731290,4334380] (n16554,n16556) Diff net spacing
EBox: M1-M1 [4719530,4324810..4731590,4333100] (n16554,n16556) Diff net spacing
EBox: M1-M1 [4719630,4325060..4732070,4334870] (n16554,n16556) Diff net spacing
EBox: M1-M1 [3912890,4399290..3924930,4409050] (n16574,n16575) Diff net spacing
EBox: M1-M1 [3716810,4492010..3729910,4502070] (n16644,n16654) Diff net spacing
EBox: M1-M1 [4040090,4425380..4052150,4435190] (n16650,n16654) Diff net spacing
EBox: M1-M1 [3782170,4425130..3795270,4435190] (n16650,n16656) Diff net spacing
EBox: M1-M1 [1449850,2176350..1457510,2188380] (final_out[15],n26148) Diff net spacing
EBox: M1-M1 [4739830,3990410..4752930,4000220] (n16736,n16748) Diff net spacing
EBox: M1-M1 [4740130,3990660..4753230,4000470] (n16736,n16748) Diff net spacing
EBox: M1-M1 [4592330,3789770..4605430,3799830] (n16748,n16750) Diff net spacing
EBox: M1-M1 [4671370,3958740..4684220,3967030] (n16748,n16753) Diff net spacing
EBox: M1-M1 [4582630,2667680..4583210,2669280] (n16839,n16840) Diff net spacing
EBox: M1-M1 [4660730,2886890..4673830,2896950] (n16837,n16847) Diff net spacing
EBox: M1-M1 [2069030,2544640..2075880,2557240] (n11277,n22372) Diff net spacing
EBox: M1-M1 [3908330,2526650..3920370,2536410] (n16858,n16859) Diff net spacing
EBox: M1-M1 [3827770,2526650..3839810,2536410] (n16862,n16863) Diff net spacing
EBox: M1-M1 [3713770,2626970..3725810,2636730] (n16868,n16869) Diff net spacing
EBox: M1-M1 [3885340,2684400..3885990,2686000] (n16918,n16919) Diff net spacing
EBox: M1-M1 [3745690,2552490..3758790,2562110] (n16928,n16940) Diff net spacing
EBox: M1-M1 [3745690,2552740..3759270,2562550] (n16928,n16940) Diff net spacing
EBox: M1-M1 [3814090,2519050..3827190,2529110] (n16928,n16940) Diff net spacing
EBox: M1-M1 [3814090,2519300..3827670,2529110] (n16928,n16940) Diff net spacing
EBox: M1-M1 [3893130,2485610..3906230,2495670] (n16938,n16940) Diff net spacing
EBox: M1-M1 [2457060,2511600..2465270,2524200] (n11520,n22396) Diff net spacing
EBox: M1-M1 [1561350,1239510..1569690,1252010] (n31254,n8033) Diff net spacing
EBox: M1-M1 [4409350,2248160..4410030,2249760] (n16977,n16979) Diff net spacing
EBox: M1-M1 [4314170,2444870..4326210,2454630] (n16998,n16999) Diff net spacing
EBox: M1-M1 [2102870,4525450..2115370,4533390] (n15353,n19132) Diff net spacing
EBox: M1-M1 [4253230,4155760..4253830,4156690] (n17063,n17064) Diff net spacing
EBox: M1-M1 [4314170,4298970..4326210,4308730] (n17070,n17071) Diff net spacing
EBox: M1-M1 [4297450,4064890..4309490,4074650] (n17084,n17085) Diff net spacing
EBox: M1-M1 [4491860,4250630..4504050,4259890] (n17128,n17129) Diff net spacing
EBox: M1-M1 [4492010,4250630..4504050,4260390] (n17128,n17129) Diff net spacing
EBox: M1-M1 [4329370,4057290..4342470,4067350] (n17130,n17136) Diff net spacing
EBox: M1-M1 [4329370,4057540..4342950,4067350] (n17130,n17136) Diff net spacing
EBox: M1-M1 [2142090,2423680..2150300,2436280] (n11903,n22384) Diff net spacing
EBox: M1-M1 [4493530,4198650..4505570,4208410] (n17140,n17141) Diff net spacing
EBox: M1-M1 [4707630,5005440..4708310,5006610] (n17156,n17157) Diff net spacing
EBox: M1-M1 [4839050,4824560..4839600,4825490] (n17179,n17180) Diff net spacing
EBox: M1-M1 [5031610,4993610..5045160,5003420] (n17220,n17230) Diff net spacing
EBox: M1-M1 [5032060,4993910..5044710,5003670] (n17220,n17230) Diff net spacing
EBox: M1-M1 [2672570,2693850..2684590,2703660] (n17262,n17263) Diff net spacing
EBox: M1-M1 [2838250,2827610..2850590,2837420] (n17282,n17283) Diff net spacing
EBox: M1-M1 [2891450,2953770..2904550,2963830] (n17312,n17324) Diff net spacing
EBox: M1-M1 [2553430,2679840..2554010,2681440] (n17319,n17320) Diff net spacing
EBox: M1-M1 [2891450,2886890..2904550,2896700] (n17314,n17329) Diff net spacing
EBox: M1-M1 [2891700,2888660..2904800,2896950] (n17314,n17329) Diff net spacing
EBox: M1-M1 [3155350,2448800..3155930,2450400] (n17364,n17365) Diff net spacing
EBox: M1-M1 [3183290,2377940..3195310,2387750] (n17372,n17373) Diff net spacing
EBox: M1-M1 [3073850,2411380..3086190,2419670] (n17381,n17382) Diff net spacing
EBox: M1-M1 [3072330,2411430..3084370,2421190] (n17382,n17383) Diff net spacing
EBox: M1-M1 [2043290,2557050..2055320,2565340] (n12447,n22372) Diff net spacing
EBox: M1-M1 [3005450,2385540..3017510,2395350] (n17406,n17407) Diff net spacing
EBox: M1-M1 [3071110,2619370..3083610,2626020] (n17402,n17421) Diff net spacing
EBox: M1-M1 [3114890,2552490..3127990,2562550] (n17412,n17418) Diff net spacing
EBox: M1-M1 [3114890,2654580..3127990,2662870] (n17418,n17422) Diff net spacing
EBox: M1-M1 [719650,1607300..726390,1621670] (n31374,n8862) Diff net spacing
EBox: M1-M1 [3715290,2177350..3727330,2187110] (n17444,n17445) Diff net spacing
EBox: M1-M1 [3650990,2192250..3663030,2201870] (n17448,n17449) Diff net spacing
EBox: M1-M1 [3713770,2277670..3725810,2287430] (n17454,n17455) Diff net spacing
EBox: M1-M1 [3499450,2318410..3512550,2328470] (n17504,n17508) Diff net spacing
EBox: M1-M1 [3424970,2184650..3438070,2194710] (n17504,n17514) Diff net spacing
EBox: M1-M1 [3552650,2318660..3564710,2328470] (n17504,n17514) Diff net spacing
EBox: M1-M1 [3745690,2151210..3758790,2161270] (n17508,n17514) Diff net spacing
EBox: M1-M1 [3525290,2151210..3538390,2161270] (n17508,n17521) Diff net spacing
EBox: M1-M1 [3421930,2210740..3434270,2220550] (n17524,n17525) Diff net spacing
EBox: M1-M1 [4027830,3819840..4028510,3821440] (n17574,n17575) Diff net spacing
EBox: M1-M1 [3955450,3990410..3968550,4000470] (n17598,n17601) Diff net spacing
EBox: M1-M1 [4242250,3726230..4255530,3732950] (n17602,n17609) Diff net spacing
EBox: M1-M1 [3940250,3990410..3953350,4000470] (n17610,n17614) Diff net spacing
EBox: M1-M1 [4184970,3789770..4198070,3799830] (n17614,n17617) Diff net spacing
EBox: M1-M1 [4700550,1743090..4710310,1755180] (aps_rename_1737_,res_out[879]) Diff net spacing
EBox: M1-M1 [3115190,2283700..3127690,2295030] (VSS,pipeline_chain_30__u_seq2/memory[88]) Diff net spacing
EBox: M1-M1 [1675450,1809180..1682040,1821780] (n10961,n31403) Diff net spacing
EBox: M1-M1 [2205680,987190..2214170,999690] (n11158,n31564) Diff net spacing
EBox: M1-M1 [2622710,3087440..2635210,3097590] (n15185,n22618) Diff net spacing
EBox: M1-M1 [3791590,2517780..3804090,2529110] (VSS,pipeline_chain_25__u_seq2/memory[0]) Diff net spacing
EBox: M1-M1 [2599700,3823210..2612300,3833360] (n15365,n22617) Diff net spacing
EBox: M1-M1 [1000570,4358160..1012610,4366540] (n15293,n22740) Diff net spacing
EBox: M1-M1 [4724870,3955700..4737370,3967030] (VSS,pipeline_chain_23__u_seq2/memory[96]) Diff net spacing
EBox: M1-M1 [4893590,4323540..4906090,4334870] (VSS,pipeline_chain_21__u_seq2/memory[120]) Diff net spacing
EBox: M1-M1 [4866230,4256660..4878730,4267990] (VSS,pipeline_chain_21__u_seq2/memory[8]) Diff net spacing
EBox: M1-M1 [3669690,2155770..3681720,2164060] (HFSNET_1923,pipeline_chain_31__u_seq2/memory[121]) Diff net spacing
EBox: M1-M1 [3662390,2216820..3674890,2227670] (HFSNET_1864,pipeline_chain_31__u_seq2/memory[49]) Diff net spacing
EBox: M1-M1 [3434090,2282180..3446120,2290470] (HFSNET_1864,pipeline_chain_31__u_seq2/memory[46]) Diff net spacing
EBox: M1-M1 [3716810,2247220..3728840,2257030] (HFSNET_1864,pipeline_chain_31__u_seq2/memory[42]) Diff net spacing
EBox: M1-M1 [3378920,2155770..3390950,2164060] (HFSNET_1864,pipeline_chain_31__u_seq2/memory[39]) Diff net spacing
EBox: M1-M1 [3454920,2289530..3466950,2297820] (HFSNET_1864,pipeline_chain_31__u_seq2/memory[38]) Diff net spacing
EBox: M1-M1 [3662090,2222650..3674120,2230940] (HFSNET_1864,pipeline_chain_31__u_seq2/memory[33]) Diff net spacing
EBox: M1-M1 [3782170,2113460..3794200,2123270] (HFSNET_1914,pipeline_chain_31__u_seq2/memory[83]) Diff net spacing
EBox: M1-M1 [3405210,2215300..3417240,2223590] (HFSNET_1865,pipeline_chain_31__u_seq2/memory[31]) Diff net spacing
EBox: M1-M1 [3768040,2180340..3780070,2190150] (HFSNET_1865,pipeline_chain_31__u_seq2/memory[27]) Diff net spacing
EBox: M1-M1 [3795850,2256090..3807880,2264380] (HFSNET_1865,pipeline_chain_31__u_seq2/memory[24]) Diff net spacing
EBox: M1-M1 [3761960,2155770..3773990,2164060] (HFSNET_1865,pipeline_chain_31__u_seq2/memory[19]) Diff net spacing
EBox: M1-M1 [3684890,2114980..3696920,2123270] (HFSNET_1865,pipeline_chain_31__u_seq2/memory[17]) Diff net spacing
EBox: M1-M1 [3844040,2189210..3856070,2197500] (HFSNET_1865,pipeline_chain_31__u_seq2/memory[16]) Diff net spacing
EBox: M1-M1 [3828840,2215300..3840870,2223590] (HFSNET_1907,pipeline_chain_31__u_seq2/memory[32]) Diff net spacing
EBox: M1-M1 [3469050,2222650..3481080,2230940] (HFSNET_1907,pipeline_chain_31__u_seq2/memory[31]) Diff net spacing
EBox: M1-M1 [3745690,2088890..3757720,2097320] (HFSNET_1928,pipeline_chain_31__u_seq2/memory[51]) Diff net spacing
EBox: M1-M1 [3663160,2213780..3675190,2223590] (HFSNET_1928,pipeline_chain_31__u_seq2/memory[49]) Diff net spacing
EBox: M1-M1 [3826250,2222650..3838280,2230940] (HFSNET_1907,pipeline_chain_31__u_seq2/memory[24]) Diff net spacing
EBox: M1-M1 [3697050,2155770..3709080,2164060] (HFSNET_1928,pipeline_chain_31__u_seq2/memory[41]) Diff net spacing
EBox: M1-M1 [3084790,2584660..3097290,2595600] (HFSNET_1866,pipeline_chain_30__u_seq2/memory[65]) Diff net spacing
EBox: M1-M1 [3142250,2482820..3154280,2491110] (HFSNET_1927,pipeline_chain_30__u_seq2/memory[125]) Diff net spacing
EBox: M1-M1 [3041930,2423290..3053960,2431670] (HFSNET_1927,pipeline_chain_30__u_seq2/memory[124]) Diff net spacing
EBox: M1-M1 [3003930,2282030..3015960,2290470] (HFSNET_1902,pipeline_chain_30__u_seq2/memory[95]) Diff net spacing
EBox: M1-M1 [3115960,2280660..3127990,2290470] (HFSNET_1902,pipeline_chain_30__u_seq2/memory[88]) Diff net spacing
EBox: M1-M1 [3035850,2389850..3047880,2398140] (HFSNET_1902,pipeline_chain_30__u_seq2/memory[84]) Diff net spacing
EBox: M1-M1 [3087080,2590490..3099110,2598780] (HFSNET_1866,pipeline_chain_30__u_seq2/memory[46]) Diff net spacing
EBox: M1-M1 [3086010,2623930..3098040,2632220] (HFSNET_1867,pipeline_chain_30__u_seq2/memory[46]) Diff net spacing
EBox: M1-M1 [3178280,2389850..3190310,2398140] (HFSNET_1866,pipeline_chain_30__u_seq2/memory[42]) Diff net spacing
EBox: M1-M1 [3086220,2618100..3098820,2629430] (HFSNET_1867,pipeline_chain_30__u_seq2/memory[38]) Diff net spacing
EBox: M1-M1 [3143320,2490170..3155350,2498460] (HFSNET_1866,pipeline_chain_30__u_seq2/memory[34]) Diff net spacing
EBox: M1-M1 [3147880,2548180..3159910,2557990] (HFSNET_1866,pipeline_chain_30__u_seq2/memory[33]) Diff net spacing
EBox: M1-M1 [3036680,2384020..3049280,2395350] (HFSNET_1902,pipeline_chain_30__u_seq2/memory[44]) Diff net spacing
EBox: M1-M1 [3036920,2356410..3048950,2366220] (HFSNET_1916,pipeline_chain_30__u_seq2/memory[31]) Diff net spacing
EBox: M1-M1 [3064730,2349310..3076760,2357350] (HFSNET_1916,pipeline_chain_30__u_seq2/memory[20]) Diff net spacing
EBox: M1-M1 [3070810,2256090..3082840,2264380] (HFSNET_1916,pipeline_chain_30__u_seq2/memory[16]) Diff net spacing
EBox: M1-M1 [2531210,2650020..2543240,2658310] (HFSNET_1900,pipeline_chain_29__u_seq2/memory[127]) Diff net spacing
EBox: M1-M1 [2599160,2783780..2611190,2792070] (HFSNET_1900,pipeline_chain_29__u_seq2/memory[123]) Diff net spacing
EBox: M1-M1 [2920330,2690810..2932360,2699100] (HFSNET_1900,pipeline_chain_29__u_seq2/memory[112]) Diff net spacing
EBox: M1-M1 [2564200,2750160..2576230,2758630] (HFSNET_1911,pipeline_chain_29__u_seq2/memory[51]) Diff net spacing
EBox: M1-M1 [2917290,2590490..2929320,2598780] (HFSNET_1911,pipeline_chain_29__u_seq2/memory[48]) Diff net spacing
EBox: M1-M1 [2562680,2649960..2574710,2658310] (HFSNET_1917,pipeline_chain_29__u_seq2/memory[47]) Diff net spacing
EBox: M1-M1 [2744010,2683460..2756040,2691750] (HFSNET_1917,pipeline_chain_29__u_seq2/memory[42]) Diff net spacing
EBox: M1-M1 [4739770,4790180..4751800,4798470] (HFSNET_1870,pipeline_chain_28__u_seq2/memory[84]) Diff net spacing
EBox: M1-M1 [4736280,4890500..4748310,4898790] (HFSNET_1870,pipeline_chain_28__u_seq2/memory[83]) Diff net spacing
EBox: M1-M1 [4953640,4998170..4965670,5006600] (HFSNET_1910,pipeline_chain_28__u_seq2/memory[122]) Diff net spacing
EBox: M1-M1 [4887210,4823620..4899240,4831910] (HFSNET_1910,pipeline_chain_28__u_seq2/memory[120]) Diff net spacing
EBox: M1-M1 [4991640,4990200..5003670,4999110] (HFSNET_1910,pipeline_chain_28__u_seq2/memory[119]) Diff net spacing
EBox: M1-M1 [4981450,5057700..4993480,5065990] (HFSNET_1896,pipeline_chain_28__u_seq2/memory[55]) Diff net spacing
EBox: M1-M1 [4470730,4020950..4482760,4029350] (HFSNET_1872,pipeline_chain_27__u_seq2/memory[126]) Diff net spacing
EBox: M1-M1 [4476810,4095290..4488840,4103580] (HFSNET_1872,pipeline_chain_27__u_seq2/memory[124]) Diff net spacing
EBox: M1-M1 [4300490,4295930..4312520,4305740] (HFSNET_1872,pipeline_chain_27__u_seq2/memory[122]) Diff net spacing
EBox: M1-M1 [4934330,4723300..4946360,4731590] (HFSNET_1908,pipeline_chain_28__u_seq2/memory[29]) Diff net spacing
EBox: M1-M1 [4820330,4931290..4832360,4939580] (HFSNET_1912,pipeline_chain_28__u_seq2/memory[32]) Diff net spacing
EBox: M1-M1 [4884170,4830970..4896200,4840780] (HFSNET_1908,pipeline_chain_28__u_seq2/memory[24]) Diff net spacing
EBox: M1-M1 [4884470,4833570..4896970,4840730] (HFSNET_1908,pipeline_chain_28__u_seq2/memory[24]) Diff net spacing
EBox: M1-M1 [4236650,4221700..4248680,4229990] (HFSNET_1872,pipeline_chain_27__u_seq2/memory[113]) Diff net spacing
EBox: M1-M1 [4477110,4089460..4489610,4100380] (HFSNET_1872,pipeline_chain_27__u_seq2/memory[92]) Diff net spacing
EBox: M1-M1 [4344870,4323540..4357370,4334480] (HFSNET_1871,pipeline_chain_27__u_seq2/memory[58]) Diff net spacing
EBox: M1-M1 [1038870,3083060..1051370,3090750] (VSS,n3672) Diff net spacing
EBox: M1-M1 [4278760,4028410..4290790,4036700] (HFSNET_1875,pipeline_chain_27__u_seq2/memory[51]) Diff net spacing
EBox: M1-M1 [4449000,4229050..4461030,4237340] (HFSNET_1873,pipeline_chain_27__u_seq2/memory[47]) Diff net spacing
EBox: M1-M1 [4277240,4321570..4289270,4330310] (HFSNET_1875,pipeline_chain_27__u_seq2/memory[48]) Diff net spacing
EBox: M1-M1 [4412520,4255060..4424550,4263430] (HFSNET_1875,pipeline_chain_27__u_seq2/memory[47]) Diff net spacing
EBox: M1-M1 [4768950,3756330..4781450,3766480] (n16748,n22434) Diff net spacing
EBox: M1-M1 [4344570,4329370..4356600,4337660] (HFSNET_1871,pipeline_chain_27__u_seq2/memory[26]) Diff net spacing
EBox: M1-M1 [4235130,4186740..4247160,4196550] (HFSNET_1871,pipeline_chain_27__u_seq2/memory[25]) Diff net spacing
EBox: M1-M1 [4247290,4288580..4259320,4296870] (HFSNET_1922,pipeline_chain_27__u_seq2/memory[24]) Diff net spacing
EBox: M1-M1 [4134810,2248560..4146840,2257030] (HFSNET_1876,pipeline_chain_26__u_seq2/memory[88]) Diff net spacing
EBox: M1-M1 [4241210,2280660..4253240,2290470] (HFSNET_1876,pipeline_chain_26__u_seq2/memory[83]) Diff net spacing
EBox: M1-M1 [4302010,2449380..4314040,2457670] (HFSNET_1918,pipeline_chain_26__u_seq2/memory[124]) Diff net spacing
EBox: M1-M1 [4350650,2423290..4362680,2431580] (HFSNET_1918,pipeline_chain_26__u_seq2/memory[119]) Diff net spacing
EBox: M1-M1 [4134810,2251530..4147910,2261590] (HFSNET_1899,pipeline_chain_26__u_seq2/memory[88]) Diff net spacing
EBox: M1-M1 [4350650,2289530..4362680,2297850] (HFSNET_1897,pipeline_chain_26__u_seq2/memory[46]) Diff net spacing
EBox: M1-M1 [4057290,2347540..4069320,2357350] (HFSNET_1897,pipeline_chain_26__u_seq2/memory[41]) Diff net spacing
EBox: M1-M1 [4380600,2523610..4392630,2533420] (HFSNET_1904,pipeline_chain_26__u_seq2/memory[39]) Diff net spacing
EBox: M1-M1 [4342600,2447860..4354630,2457670] (HFSNET_1899,pipeline_chain_26__u_seq2/memory[28]) Diff net spacing
EBox: M1-M1 [4156090,2289530..4168120,2299340] (HFSNET_1904,pipeline_chain_26__u_seq2/memory[32]) Diff net spacing
EBox: M1-M1 [4379530,2423290..4391560,2431580] (HFSNET_1930,pipeline_chain_26__u_seq2/memory[55]) Diff net spacing
EBox: M1-M1 [4350650,2415940..4362680,2424230] (HFSNET_1899,pipeline_chain_26__u_seq2/memory[23]) Diff net spacing
EBox: M1-M1 [4366920,2389850..4378950,2397890] (HFSNET_1930,pipeline_chain_26__u_seq2/memory[54]) Diff net spacing
EBox: M1-M1 [4301560,2256090..4313590,2264470] (HFSNET_1904,pipeline_chain_26__u_seq2/memory[27]) Diff net spacing
EBox: M1-M1 [4203210,2516260..4215240,2524550] (HFSNET_1899,pipeline_chain_26__u_seq2/memory[21]) Diff net spacing
EBox: M1-M1 [4156090,2315620..4168120,2323910] (HFSNET_1904,pipeline_chain_26__u_seq2/memory[24]) Diff net spacing
EBox: M1-M1 [3912440,2683340..3924470,2691750] (HFSNET_1879,pipeline_chain_25__u_seq2/memory[126]) Diff net spacing
EBox: M1-M1 [4376040,2222650..4388070,2230940] (HFSNET_1899,pipeline_chain_26__u_seq2/memory[18]) Diff net spacing
EBox: M1-M1 [3956970,2583140..3969000,2591430] (HFSNET_1879,pipeline_chain_25__u_seq2/memory[125]) Diff net spacing
EBox: M1-M1 [4203210,2349060..4215240,2357350] (HFSNET_1899,pipeline_chain_26__u_seq2/memory[17]) Diff net spacing
EBox: M1-M1 [3941320,2623930..3953350,2632220] (HFSNET_1879,pipeline_chain_25__u_seq2/memory[124]) Diff net spacing
EBox: M1-M1 [4134810,2256090..4146840,2264380] (HFSNET_1899,pipeline_chain_26__u_seq2/memory[16]) Diff net spacing
EBox: M1-M1 [4370410,2447860..4382440,2457670] (HFSNET_1930,pipeline_chain_26__u_seq2/memory[47]) Diff net spacing
EBox: M1-M1 [3941770,2456730..3953800,2465120] (HFSNET_1879,pipeline_chain_25__u_seq2/memory[123]) Diff net spacing
EBox: M1-M1 [4379530,2322970..4391560,2331130] (HFSNET_1930,pipeline_chain_26__u_seq2/memory[46]) Diff net spacing
EBox: M1-M1 [4282250,2449380..4294280,2457670] (HFSNET_1930,pipeline_chain_26__u_seq2/memory[44]) Diff net spacing
EBox: M1-M1 [3814090,2791130..3826120,2799400] (HFSNET_1879,pipeline_chain_25__u_seq2/memory[118]) Diff net spacing
EBox: M1-M1 [3911370,2616580..3923400,2624870] (HFSNET_1879,pipeline_chain_25__u_seq2/memory[117]) Diff net spacing
EBox: M1-M1 [3945880,2482950..3957910,2491110] (HFSNET_1879,pipeline_chain_25__u_seq2/memory[112]) Diff net spacing
EBox: M1-M1 [3911370,2623930..3923400,2632220] (HFSNET_1877,pipeline_chain_25__u_seq2/memory[53]) Diff net spacing
EBox: M1-M1 [3926120,2490170..3938150,2498510] (HFSNET_1877,pipeline_chain_25__u_seq2/memory[51]) Diff net spacing
EBox: M1-M1 [3911370,2650020..3923400,2658310] (HFSNET_1877,pipeline_chain_25__u_seq2/memory[45]) Diff net spacing
EBox: M1-M1 [3986920,2690810..3998950,2699170] (HFSNET_1878,pipeline_chain_25__u_seq2/memory[46]) Diff net spacing
EBox: M1-M1 [3911370,2657370..3923400,2667180] (HFSNET_1878,pipeline_chain_25__u_seq2/memory[45]) Diff net spacing
EBox: M1-M1 [3666650,2590490..3678680,2600300] (HFSNET_1878,pipeline_chain_25__u_seq2/memory[41]) Diff net spacing
EBox: M1-M1 [3911370,2690810..3923400,2699100] (HFSNET_1878,pipeline_chain_25__u_seq2/memory[38]) Diff net spacing
EBox: M1-M1 [3627130,2557050..3639160,2565340] (HFSNET_1878,pipeline_chain_25__u_seq2/memory[34]) Diff net spacing
EBox: M1-M1 [3716810,2616580..3728840,2624870] (HFSNET_1880,pipeline_chain_25__u_seq2/memory[25]) Diff net spacing
EBox: M1-M1 [3846010,2456730..3858040,2465180] (HFSNET_1880,pipeline_chain_25__u_seq2/memory[16]) Diff net spacing
EBox: M1-M1 [4523930,2891450..4535960,2899740] (HFSNET_1882,pipeline_chain_24__u_seq2/memory[123]) Diff net spacing
EBox: M1-M1 [4662250,2623930..4674280,2633740] (HFSNET_1882,pipeline_chain_24__u_seq2/memory[119]) Diff net spacing
EBox: M1-M1 [3942840,2716900..3954870,2725190] (HFSNET_1931,pipeline_chain_25__u_seq2/memory[38]) Diff net spacing
EBox: M1-M1 [4657690,2950980..4669720,2959270] (HFSNET_1882,pipeline_chain_24__u_seq2/memory[113]) Diff net spacing
EBox: M1-M1 [3941320,2616580..3953350,2624870] (HFSNET_1931,pipeline_chain_25__u_seq2/memory[29]) Diff net spacing
EBox: M1-M1 [3858170,2716900..3870200,2725190] (HFSNET_1931,pipeline_chain_25__u_seq2/memory[28]) Diff net spacing
EBox: M1-M1 [4642490,2581620..4654520,2591430] (HFSNET_1921,pipeline_chain_24__u_seq2/memory[93]) Diff net spacing
EBox: M1-M1 [4561480,2783780..4573510,2792070] (HFSNET_1921,pipeline_chain_24__u_seq2/memory[88]) Diff net spacing
EBox: M1-M1 [4540650,2616580..4552680,2624870] (HFSNET_1881,pipeline_chain_24__u_seq2/memory[21]) Diff net spacing
EBox: M1-M1 [4692650,2456730..4704680,2465020] (HFSNET_1906,pipeline_chain_24__u_seq2/memory[46]) Diff net spacing
EBox: M1-M1 [4657690,2415830..4669720,2424230] (HFSNET_1881,pipeline_chain_24__u_seq2/memory[18]) Diff net spacing
EBox: M1-M1 [4718490,2482820..4730520,2491110] (HFSNET_1909,pipeline_chain_24__u_seq2/memory[38]) Diff net spacing
EBox: M1-M1 [4523930,2884030..4535960,2892390] (HFSNET_1909,pipeline_chain_24__u_seq2/memory[35]) Diff net spacing
EBox: M1-M1 [4625770,3928090..4637800,3936550] (HFSNET_1903,pipeline_chain_23__u_seq2/memory[123]) Diff net spacing
EBox: M1-M1 [4495050,2850310..4507080,2858950] (HFSNET_1933,pipeline_chain_24__u_seq2/memory[24]) Diff net spacing
EBox: M1-M1 [4739770,3820420..4751800,3828710] (HFSNET_1903,pipeline_chain_23__u_seq2/memory[118]) Diff net spacing
EBox: M1-M1 [4887210,3820380..4899240,3828710] (HFSNET_1903,pipeline_chain_23__u_seq2/memory[117]) Diff net spacing
EBox: M1-M1 [4762120,3861210..4774150,3869500] (HFSNET_1903,pipeline_chain_23__u_seq2/memory[116]) Diff net spacing
EBox: M1-M1 [4626840,3820420..4638850,3828710] (HFSNET_1884,pipeline_chain_23__u_seq2/memory[95]) Diff net spacing
EBox: M1-M1 [4718490,3794330..4730520,3802660] (HFSNET_1884,pipeline_chain_23__u_seq2/memory[92]) Diff net spacing
EBox: M1-M1 [4884170,3853860..4896200,3862150] (HFSNET_1884,pipeline_chain_23__u_seq2/memory[88]) Diff net spacing
EBox: M1-M1 [4818810,3861210..4830840,3869500] (HFSNET_1884,pipeline_chain_23__u_seq2/memory[86]) Diff net spacing
EBox: M1-M1 [4934330,3827770..4946360,3836060] (HFSNET_1884,pipeline_chain_23__u_seq2/memory[85]) Diff net spacing
EBox: M1-M1 [4704360,3928090..4716390,3936390] (HFSNET_1884,pipeline_chain_23__u_seq2/memory[83]) Diff net spacing
EBox: M1-M1 [4799050,4021060..4811080,4029350] (HFSNET_1884,pipeline_chain_23__u_seq2/memory[81]) Diff net spacing
EBox: M1-M1 [4718490,3786980..4730520,3795270] (HFSNET_1885,pipeline_chain_23__u_seq2/memory[44]) Diff net spacing
EBox: M1-M1 [4981450,3987620..4993480,3995910] (HFSNET_1885,pipeline_chain_23__u_seq2/memory[42]) Diff net spacing
EBox: M1-M1 [4695690,3827770..4707720,3836060] (HFSNET_1885,pipeline_chain_23__u_seq2/memory[38]) Diff net spacing
EBox: M1-M1 [4669400,3987620..4681430,3995910] (HFSNET_1885,pipeline_chain_23__u_seq2/memory[35]) Diff net spacing
EBox: M1-M1 [4740840,3827770..4752870,3836060] (HFSNET_1886,pipeline_chain_23__u_seq2/memory[36]) Diff net spacing
EBox: M1-M1 [4800570,3987520..4812600,3995910] (HFSNET_1885,pipeline_chain_23__u_seq2/memory[33]) Diff net spacing
EBox: M1-M1 [5010330,3861210..5022360,3871020] (HFSNET_1883,pipeline_chain_23__u_seq2/memory[29]) Diff net spacing
EBox: M1-M1 [4919130,4020870..4931160,4029350] (HFSNET_1883,pipeline_chain_23__u_seq2/memory[26]) Diff net spacing
EBox: M1-M1 [4623800,3961530..4635830,3969820] (HFSNET_1883,pipeline_chain_23__u_seq2/memory[19]) Diff net spacing
EBox: M1-M1 [4919130,3994970..4931160,4003410] (HFSNET_1883,pipeline_chain_23__u_seq2/memory[18]) Diff net spacing
EBox: M1-M1 [3745990,4323540..3758490,4334380] (HFSNET_1888,pipeline_chain_22__u_seq2/memory[126]) Diff net spacing
EBox: M1-M1 [3745690,4320500..3757720,4330310] (HFSNET_1889,pipeline_chain_22__u_seq2/memory[126]) Diff net spacing
EBox: M1-M1 [3689450,4496570..3701480,4505030] (HFSNET_1889,pipeline_chain_22__u_seq2/memory[125]) Diff net spacing
EBox: M1-M1 [4009720,4429690..4021750,4438160] (HFSNET_1889,pipeline_chain_22__u_seq2/memory[121]) Diff net spacing
EBox: M1-M1 [3956520,4429690..3968550,4438090] (HFSNET_1889,pipeline_chain_22__u_seq2/memory[120]) Diff net spacing
EBox: M1-M1 [4019290,4396250..4031320,4404540] (HFSNET_1889,pipeline_chain_22__u_seq2/memory[114]) Diff net spacing
EBox: M1-M1 [3976730,4429690..3988760,4437980] (HFSNET_1889,pipeline_chain_22__u_seq2/memory[113]) Diff net spacing
EBox: M1-M1 [3572710,4457300..3585210,4468240] (HFSNET_1888,pipeline_chain_22__u_seq2/memory[63]) Diff net spacing
EBox: M1-M1 [4058360,4463130..4070390,4471420] (HFSNET_1913,pipeline_chain_22__u_seq2/memory[82]) Diff net spacing
EBox: M1-M1 [3572410,4463130..3584440,4471420] (HFSNET_1888,pipeline_chain_22__u_seq2/memory[39]) Diff net spacing
EBox: M1-M1 [3745690,4362810..3757720,4371100] (HFSNET_1887,pipeline_chain_22__u_seq2/memory[38]) Diff net spacing
EBox: M1-M1 [3745690,4329370..3757720,4337660] (HFSNET_1888,pipeline_chain_22__u_seq2/memory[38]) Diff net spacing
EBox: M1-M1 [3912440,4329370..3924470,4337850] (HFSNET_1887,pipeline_chain_22__u_seq2/memory[35]) Diff net spacing
EBox: M1-M1 [3911370,4295930..3923400,4304400] (HFSNET_1888,pipeline_chain_22__u_seq2/memory[35]) Diff net spacing
EBox: M1-M1 [4107450,4429690..4119480,4438070] (HFSNET_1887,pipeline_chain_22__u_seq2/memory[34]) Diff net spacing
EBox: M1-M1 [3925050,4496570..3937080,4504860] (HFSNET_1887,pipeline_chain_22__u_seq2/memory[32]) Diff net spacing
EBox: M1-M1 [3912440,4489220..3924470,4497510] (HFSNET_1888,pipeline_chain_22__u_seq2/memory[32]) Diff net spacing
EBox: M1-M1 [3943290,4355460..3955320,4363750] (HFSNET_1887,pipeline_chain_22__u_seq2/memory[27]) Diff net spacing
EBox: M1-M1 [4059880,4396250..4071910,4404710] (HFSNET_1887,pipeline_chain_22__u_seq2/memory[26]) Diff net spacing
EBox: M1-M1 [4984490,4221600..4996520,4229990] (HFSNET_1901,pipeline_chain_21__u_seq2/memory[123]) Diff net spacing
EBox: M1-M1 [5020970,4321960..5033000,4330310] (HFSNET_1901,pipeline_chain_21__u_seq2/memory[121]) Diff net spacing
EBox: M1-M1 [4893290,4320500..4905320,4330310] (HFSNET_1901,pipeline_chain_21__u_seq2/memory[120]) Diff net spacing
EBox: M1-M1 [4853770,4429690..4865800,4439500] (HFSNET_1901,pipeline_chain_21__u_seq2/memory[117]) Diff net spacing
EBox: M1-M1 [4625320,4329370..4637350,4337660] (HFSNET_1892,pipeline_chain_21__u_seq2/memory[55]) Diff net spacing
EBox: M1-M1 [4787960,4288580..4799990,4296870] (HFSNET_1892,pipeline_chain_21__u_seq2/memory[54]) Diff net spacing
EBox: M1-M1 [4769720,4489050..4781750,4497510] (HFSNET_1892,pipeline_chain_21__u_seq2/memory[52]) Diff net spacing
EBox: M1-M1 [4887210,4229050..4899240,4237340] (HFSNET_1892,pipeline_chain_21__u_seq2/memory[51]) Diff net spacing
EBox: M1-M1 [4990570,4429690..5002600,4437980] (HFSNET_1932,pipeline_chain_21__u_seq2/memory[90]) Diff net spacing
EBox: M1-M1 [4794490,4489220..4806520,4497510] (HFSNET_1892,pipeline_chain_21__u_seq2/memory[44]) Diff net spacing
EBox: M1-M1 [4960170,4288580..4972200,4296870] (HFSNET_1893,pipeline_chain_21__u_seq2/memory[32]) Diff net spacing
EBox: M1-M1 [3209430,2218000..3221930,2228150] (n17422,n22567) Diff net spacing
EBox: M1-M1 [3209430,2418640..3221930,2428790] (n17422,n22567) Diff net spacing
EBox: M1-M1 [4951050,4362810..4963080,4371100] (HFSNET_1924,pipeline_chain_21__u_seq2/memory[25]) Diff net spacing
EBox: M1-M1 [4934330,4262490..4946360,4272300] (HFSNET_1924,pipeline_chain_21__u_seq2/memory[19]) Diff net spacing
EBox: M1-M1 [2967750,2485520..2980250,2495670] (n17412,n22669) Diff net spacing
EBox: M1-M1 [2120230,289850..2120810,291450] (n14195,n31311) Diff net spacing
EBox: M1-M1 [1883110,1058860..1883690,1060270] (n14199,n31387) Diff net spacing
EBox: M1-M1 [2886310,1527020..2886890,1528440] (n14196,n31471) Diff net spacing
EBox: M1-M1 [2314790,1647140..2315370,1648500] (n14126,n31558) Diff net spacing
EBox: M1-M1 [686230,3973690..698780,3981640] (VDD,n7017) Diff net spacing
EBox: M1-M1 [698340,1601560..710890,1609510] (VDD,n7166) Diff net spacing
EBox: M1-M1 [1301960,4213650..1308250,4225960] (VDD,n7610) Diff net spacing
EBox: M1-M1 [1713460,1198170..1726250,1206120] (VDD,n7888) Diff net spacing
EBox: M1-M1 [221110,1283850..233210,1291580] (n21221,n22542) Diff net spacing
EBox: M1-M1 [3037370,2657620..3043620,2670220] (n17425,n31433) Diff net spacing
EBox: M1-M1 [2583830,3185360..2584410,3186740] (n17709,n31284) Diff net spacing
EBox: M1-M1 [2032660,930650..2045450,938500] (VDD,n8123) Diff net spacing
EBox: M1-M1 [2585350,3399770..2585930,3401370] (n17745,n31336) Diff net spacing
EBox: M1-M1 [2512970,4496870..2519990,4509370] (n17890,n31352) Diff net spacing
EBox: M1-M1 [366710,791570..379830,799050] (n21156,n22926) Diff net spacing
EBox: M1-M1 [366730,791570..379830,799100] (n21156,n22926) Diff net spacing
EBox: M1-M1 [1341990,4470400..1342570,4472000] (n17629,n31595) Diff net spacing
EBox: M1-M1 [422390,1961850..422970,1963450] (n18217,n31422) Diff net spacing
EBox: M1-M1 [220230,2062060..220810,2063430] (n18282,n31373) Diff net spacing
EBox: M1-M1 [1759990,1427360..1760570,1428960] (n18269,n31403) Diff net spacing
EBox: M1-M1 [3316470,309480..3317050,310900] (n18372,n31319) Diff net spacing
EBox: M1-M1 [4008650,3786800..4020680,3795270] (n17601,pipeline_chain_0__u_seq2/memory[124]) Diff net spacing
EBox: M1-M1 [3955450,3994970..3967480,4003260] (n17601,pipeline_chain_0__u_seq2/memory[121]) Diff net spacing
EBox: M1-M1 [4184970,3794330..4197000,3804140] (n17617,pipeline_chain_0__u_seq2/memory[102]) Diff net spacing
EBox: M1-M1 [3894200,3827770..3906230,3836220] (n17604,pipeline_chain_0__u_seq2/memory[88]) Diff net spacing
EBox: M1-M1 [3879450,3994970..3891480,4003260] (n17615,pipeline_chain_0__u_seq2/memory[98]) Diff net spacing
EBox: M1-M1 [3856200,3961530..3868230,3969820] (n17602,pipeline_chain_0__u_seq2/memory[83]) Diff net spacing
EBox: M1-M1 [3625030,1594010..3625610,1595610] (n18514,n31297) Diff net spacing
EBox: M1-M1 [4009720,3961530..4021750,3969820] (n17602,pipeline_chain_0__u_seq2/memory[81]) Diff net spacing
EBox: M1-M1 [4204730,3820210..4216760,3828710] (n17615,pipeline_chain_0__u_seq2/memory[94]) Diff net spacing
EBox: M1-M1 [3926120,3928090..3938150,3936380] (n17599,pipeline_chain_0__u_seq2/memory[74]) Diff net spacing
EBox: M1-M1 [3828840,3987530..3840870,3995910] (n17602,pipeline_chain_0__u_seq2/memory[75]) Diff net spacing
EBox: M1-M1 [4009720,4028410..4021750,4036700] (n17602,pipeline_chain_0__u_seq2/memory[73]) Diff net spacing
EBox: M1-M1 [4212330,3827770..4224360,3836100] (n17614,pipeline_chain_0__u_seq2/memory[70]) Diff net spacing
EBox: M1-M1 [3961530,3794330..3973560,3802620] (n17614,pipeline_chain_0__u_seq2/memory[68]) Diff net spacing
EBox: M1-M1 [4186040,3760890..4198070,3769180] (n17610,pipeline_chain_0__u_seq2/memory[63]) Diff net spacing
EBox: M1-M1 [3940250,3994970..3952280,4004780] (n17614,pipeline_chain_0__u_seq2/memory[66]) Diff net spacing
EBox: M1-M1 [4184970,3786820..4197000,3795270] (n17614,pipeline_chain_0__u_seq2/memory[63]) Diff net spacing
EBox: M1-M1 [3941320,3987260..3953350,3995910] (n17610,pipeline_chain_0__u_seq2/memory[58]) Diff net spacing
EBox: M1-M1 [3988890,3987620..4000920,3995910] (n17610,pipeline_chain_0__u_seq2/memory[57]) Diff net spacing
EBox: M1-M1 [3862730,3853860..3874760,3862150] (n17610,pipeline_chain_0__u_seq2/memory[56]) Diff net spacing
EBox: M1-M1 [1259910,3552870..1260490,3554470] (n18483,n31363) Diff net spacing
EBox: M1-M1 [3941320,3961530..3953350,3969820] (n17614,pipeline_chain_0__u_seq2/memory[58]) Diff net spacing
EBox: M1-M1 [4141960,3853860..4153990,3862150] (n17610,pipeline_chain_0__u_seq2/memory[54]) Diff net spacing
EBox: M1-M1 [4008650,3994970..4020680,4003260] (n17614,pipeline_chain_0__u_seq2/memory[57]) Diff net spacing
EBox: M1-M1 [3745690,3954180..3757720,3962470] (n17610,pipeline_chain_0__u_seq2/memory[51]) Diff net spacing
EBox: M1-M1 [1498550,3867820..1499130,3869250] (n18492,n31359) Diff net spacing
EBox: M1-M1 [3301270,390170..3301850,391770] (n18307,n31553) Diff net spacing
EBox: M1-M1 [3815160,3994970..3827190,4003310] (n17613,pipeline_chain_0__u_seq2/memory[43]) Diff net spacing
EBox: M1-M1 [3251110,256300..3251690,257640] (n18304,n31557) Diff net spacing
EBox: M1-M1 [3795850,3987620..3807880,3995910] (n17613,pipeline_chain_0__u_seq2/memory[35]) Diff net spacing
EBox: M1-M1 [3796920,4061850..3808950,4070140] (n17612,pipeline_chain_0__u_seq2/memory[27]) Diff net spacing
EBox: M1-M1 [4088760,3894650..4100790,3902980] (n17598,pipeline_chain_0__u_seq2/memory[13]) Diff net spacing
EBox: M1-M1 [3953930,3760890..3965960,3769180] (n17598,pipeline_chain_0__u_seq2/memory[12]) Diff net spacing
EBox: M1-M1 [3955450,3987620..3967480,3995910] (n17598,pipeline_chain_0__u_seq2/memory[2]) Diff net spacing
EBox: M1-M1 [3824730,3853790..3836760,3862150] (n17605,pipeline_chain_0__u_seq2/memory[8]) Diff net spacing
EBox: M1-M1 [3961530,4054500..3973560,4062790] (n17598,pipeline_chain_0__u_seq2/memory[1]) Diff net spacing
EBox: M1-M1 [3768040,4061850..3780070,4070300] (n17601,pipeline_chain_0__u_seq2/memory[3]) Diff net spacing
EBox: M1-M1 [2133910,1579910..2134490,1581510] (n18331,n31558) Diff net spacing
EBox: M1-M1 [4258870,1512480..4259450,1514080] (n18448,n31454) Diff net spacing
EBox: M1-M1 [892900,395610..905450,403560] (VDD,n8684) Diff net spacing
EBox: M1-M1 [661030,1359820..661610,1361160] (n18599,n31310) Diff net spacing
EBox: M1-M1 [1522870,3366790..1523450,3368390] (n18296,n31615) Diff net spacing
EBox: M1-M1 [2633990,1226170..2634570,1227770] (n18455,n31470) Diff net spacing
EBox: M1-M1 [4500550,1178080..4501130,1179680] (n18507,n31446) Diff net spacing
EBox: M1-M1 [3251110,1579360..3251690,1580960] (n18517,n31452) Diff net spacing
EBox: M1-M1 [1500070,3787330..1500650,3788660] (n18615,n31359) Diff net spacing
EBox: M1-M1 [901130,1487270..908490,1500770] (HFSNET_2535,n6364) Diff net spacing
EBox: M1-M1 [317510,3720070..318090,3721670] (n18606,n31370) Diff net spacing
EBox: M1-M1 [884470,3065260..885050,3066640] (n18419,n31589) Diff net spacing
EBox: M1-M1 [285590,2430010..286170,2431610] (n18730,n31328) Diff net spacing
EBox: M1-M1 [1556310,308640..1556890,310240] (n18589,n31472) Diff net spacing
EBox: M1-M1 [4696630,1445600..4697210,1447200] (n18557,n31511) Diff net spacing
EBox: M1-M1 [1355670,1393260..1356250,1394640] (n18661,n31435) Diff net spacing
EBox: M1-M1 [966550,2884120..967130,2885720] (n18735,n31371) Diff net spacing
EBox: M1-M1 [414790,2095500..415370,2096870] (n18729,n31380) Diff net spacing
EBox: M1-M1 [4500550,1627340..4501130,1628690] (n18626,n31503) Diff net spacing
EBox: M1-M1 [285590,1427360..286170,1428960] (n18536,n31632) Diff net spacing
EBox: M1-M1 [1647510,476390..1648090,477990] (n18717,n31472) Diff net spacing
EBox: M1-M1 [4857750,2229260..4858330,2230590] (n18756,n31442) Diff net spacing
EBox: M1-M1 [4941350,2114400..4941930,2116000] (n18760,n31445) Diff net spacing
EBox: M1-M1 [4929190,2095500..4929770,2096870] (n18763,n31445) Diff net spacing
EBox: M1-M1 [288630,323180..289210,324510] (n18659,n31550) Diff net spacing
EBox: M1-M1 [1925670,590700..1926250,592050] (n18782,n31474) Diff net spacing
EBox: M1-M1 [981750,3968140..982330,3969470] (n18928,n31329) Diff net spacing
EBox: M1-M1 [4223910,1460250..4224490,1461850] (n18814,n31453) Diff net spacing
EBox: M1-M1 [4334870,1493690..4335450,1495290] (n18769,n31500) Diff net spacing
EBox: M1-M1 [2375590,858330..2376170,859930] (n18716,n31564) Diff net spacing
EBox: M1-M1 [3556630,1713670..3557210,1715270] (n18771,n31522) Diff net spacing
EBox: M1-M1 [1647510,4101900..1648090,4103280] (n18936,n31367) Diff net spacing
EBox: M1-M1 [1975830,3719520..1976410,3721120] (n19065,n31285) Diff net spacing
EBox: M1-M1 [3737510,1010880..3738090,1012480] (n18942,n31416) Diff net spacing
EBox: M1-M1 [756790,2530220..757370,2531580] (n18987,n31379) Diff net spacing
EBox: M1-M1 [2681110,1747110..2681690,1748710] (n19094,n31287) Diff net spacing
EBox: M1-M1 [2296550,308640..2297130,310240] (n19028,n31410) Diff net spacing
EBox: M1-M1 [740070,3151590..740650,3153190] (n19054,n31385) Diff net spacing
EBox: M1-M1 [2181030,758010..2181610,759610] (n18908,n31541) Diff net spacing
EBox: M1-M1 [1031910,209250..1032490,210580] (n19039,n31419) Diff net spacing
EBox: M1-M1 [1878550,4369420..1879130,4370930] (n18874,n31601) Diff net spacing
EBox: M1-M1 [4081030,1545920..4081610,1547520] (n19078,n31453) Diff net spacing
EBox: M1-M1 [4191990,2062060..4192570,2063470] (n19261,n31298) Diff net spacing
EBox: M1-M1 [3304310,1747490..3304890,1748820] (n19090,n31471) Diff net spacing
EBox: M1-M1 [3219190,1780550..3219770,1782150] (n19091,n31471) Diff net spacing
EBox: M1-M1 [2606630,1560460..2607210,1561840] (n18903,n31660) Diff net spacing
EBox: M1-M1 [250630,2381920..251210,2383520] (n19242,n31328) Diff net spacing
EBox: M1-M1 [1550230,242310..1550810,243910] (n19165,n31419) Diff net spacing
EBox: M1-M1 [1110950,3319070..1111530,3320500] (n18995,n31590) Diff net spacing
EBox: M1-M1 [1273590,1894860..1274170,1896210] (n19173,n31434) Diff net spacing
EBox: M1-M1 [4237590,1814370..4238170,1815700] (n19197,n31449) Diff net spacing
EBox: M1-M1 [4211750,1627450..4212330,1629050] (n19200,n31449) Diff net spacing
EBox: M1-M1 [1785830,1259500..1786410,1260850] (n19034,n31630) Diff net spacing
EBox: M1-M1 [2068550,3352600..2069130,3353940] (n19191,n31475) Diff net spacing
EBox: M1-M1 [480150,2898060..480730,2899470] (n19053,n31622) Diff net spacing
EBox: M1-M1 [1070490,1609330..1078730,1621420] (final_out[535],n8496) Diff net spacing
EBox: M1-M1 [4371350,1847430..4371930,1849030] (n19269,n31438) Diff net spacing
EBox: M1-M1 [4223910,1948130..4224490,1949460] (n19209,n31505) Diff net spacing
EBox: M1-M1 [2149110,4221980..2149690,4223380] (n19130,n31592) Diff net spacing
EBox: M1-M1 [1953030,4388320..1953610,4389920] (n19125,n31601) Diff net spacing
EBox: M1-M1 [398070,4135340..398650,4136700] (n19378,n31370) Diff net spacing
EBox: M1-M1 [1550230,323180..1550810,324540] (n19101,n31661) Diff net spacing
EBox: M1-M1 [3673670,810790..3674250,812390] (n19464,n31320) Diff net spacing
EBox: M1-M1 [3495830,858220..3496410,859590] (n19471,n31323) Diff net spacing
EBox: M1-M1 [1468150,1594010..1468730,1595610] (n19301,n31519) Diff net spacing
EBox: M1-M1 [429990,4188600..430570,4189940] (n19250,n31582) Diff net spacing
EBox: M1-M1 [4891190,1646240..4891770,1647840] (n19329,n31506) Diff net spacing
EBox: M1-M1 [1204550,763450..1217100,771400] (VDD,n9618) Diff net spacing
EBox: M1-M1 [1708310,4321990..1708890,4323590] (n19260,n31584) Diff net spacing
EBox: M1-M1 [1101190,665340..1113980,673190] (VDD,n9632) Diff net spacing
EBox: M1-M1 [2068550,810240..2069130,811840] (n19226,n31630) Diff net spacing
EBox: M1-M1 [3527750,509830..3528330,511430] (n19461,n31395) Diff net spacing
EBox: M1-M1 [1842070,4120800..1842650,4122400] (n19510,n31359) Diff net spacing
EBox: M1-M1 [220230,610510..220810,611860] (n19426,n31469) Diff net spacing
EBox: M1-M1 [1079030,356620..1079610,357980] (n19615,n31286) Diff net spacing
EBox: M1-M1 [3241990,290400..3242570,292000] (n19584,n31319) Diff net spacing
EBox: M1-M1 [1759990,3553230..1760570,3554580] (n19448,n31481) Diff net spacing
EBox: M1-M1 [3511030,1078680..3511610,1080020] (n19663,n31312) Diff net spacing
EBox: M1-M1 [901190,1948040..901770,1949460] (n19621,n31376) Diff net spacing
EBox: M1-M1 [1273590,2396460..1274170,2397830] (n19625,n31378) Diff net spacing
EBox: M1-M1 [1694630,3552870..1695210,3554470] (n19388,n31625) Diff net spacing
EBox: M1-M1 [1943910,691020..1944490,692430] (n19546,n31474) Diff net spacing
EBox: M1-M1 [758310,1259500..758890,1260850] (n19494,n31532) Diff net spacing
EBox: M1-M1 [2363430,242610..2364010,244020] (n19607,n31421) Diff net spacing
EBox: M1-M1 [1219700,2003270..1232540,2010790] (VDD,n9828) Diff net spacing
EBox: M1-M1 [3480630,910560..3481210,912160] (n19535,n31539) Diff net spacing
EBox: M1-M1 [2217510,256300..2218090,257660] (n19543,n31533) Diff net spacing
EBox: M1-M1 [3469990,491040..3470570,492640] (n19525,n31556) Diff net spacing
EBox: M1-M1 [2375590,3266010..2376170,3267610] (n19772,n31360) Diff net spacing
EBox: M1-M1 [688390,1092410..688970,1094010] (n19619,n31532) Diff net spacing
EBox: M1-M1 [346390,3084160..346970,3085760] (n19821,n31372) Diff net spacing
EBox: M1-M1 [2263110,3299340..2263690,3300770] (n19834,n31360) Diff net spacing
EBox: M1-M1 [2667430,643040..2668010,644640] (n19667,n31543) Diff net s

 
  The optimized via conversion rate based on total routed via count =  0.00% (0 / 374171 vias)
 
    Layer VIA1       =  0.00% (0      / 164022  vias)
        Un-optimized =  0.00% (0       vias)
        Un-mapped    = 100.00% (164022  vias)
    Layer VIA2       =  0.00% (0      / 154666  vias)
        Un-optimized =  0.00% (0       vias)
        Un-mapped    = 100.00% (154666  vias)
    Layer VIA3       =  0.00% (0      / 33681   vias)
        Un-optimized =  0.00% (0       vias)
        Un-mapped    = 100.00% (33681   vias)
    Layer VIA4       =  0.00% (0      / 14422   vias)
        Un-optimized =  0.00% (0       vias)
        Un-mapped    = 100.00% (14422   vias)
    Layer VIA5       =  0.00% (0      / 4996    vias)
        Un-optimized =  0.00% (0       vias)
        Un-mapped    = 100.00% (4996    vias)
    Layer VIA6       =  0.00% (0      / 2302    vias)
        Un-optimized =  0.00% (0       vias)
        Un-mapped    = 100.00% (2302    vias)
    Layer VIA7       =  0.00% (0      / 82      vias)
        Un-optimized =  0.00% (0       vias)
        Un-mapped    = 100.00% (82      vias)
 


Verify Summary:

Total number of nets = 41962, of which 0 are not extracted
Total number of open nets = 0, of which 0 are frozen
Total number of excluded ports = 0 ports of 0 unplaced cells connected to 0 nets
                                 0 ports without pins of 0 cells connected to 0 nets
                                 0 ports of 0 cover cells connected to 0 non-pg nets
Total number of DRCs = 32988
Total number of antenna violations = no antenna rules defined
Total number of tie to rail violations = not checked

